1,8751,8751,8751,256059356,3.41757e-05
2,3899,7798,16549,256059356,6.46295e-05
3,2252,6756,23305,256059356,9.10141e-05
4,1445,5780,29085,256059356,0.000113587
5,1070,5350,34435,256059356,0.000134481
6,945,5670,40105,256059356,0.000156624
7,667,4669,44774,256059356,0.000174858
8,617,4936,49710,256059356,0.000194135
9,553,4977,54687,256059356,0.000213572
10,465,4650,59337,256059356,0.000231731
11,398,4378,63715,256059356,0.000248829
12,376,4512,68227,256059356,0.00026645
13,368,4784,73011,256059356,0.000285133
14,348,4872,77883,256059356,0.00030416
15,295,4425,82308,256059356,0.000321441
16,273,4368,86676,256059356,0.0003385
17,274,4658,91334,256059356,0.000356691
18,216,3888,95222,256059356,0.000371875
19,183,3477,98699,256059356,0.000385454
20,198,3960,102659,256059356,0.000400919
21,211,4431,107090,256059356,0.000418223
22,188,4136,111226,256059356,0.000434376
23,187,4301,115527,256059356,0.000451173
24,164,3936,119463,256059356,0.000466544
25,160,4000,123463,256059356,0.000482166
26,187,4862,128325,256059356,0.000501153
27,142,3834,132159,256059356,0.000516126
28,146,4088,136247,256059356,0.000532091
29,113,3277,139524,256059356,0.000544889
30,126,3780,143304,256059356,0.000559651
31,112,3472,146776,256059356,0.000573211
32,107,3424,150200,256059356,0.000586583
33,98,3234,153434,256059356,0.000599213
34,92,3128,156562,256059356,0.000611429
35,96,3360,159922,256059356,0.000624551
36,129,4644,164566,256059356,0.000642687
37,77,2849,167415,256059356,0.000653813
38,101,3838,171253,256059356,0.000668802
39,77,3003,174256,256059356,0.00068053
40,105,4200,178456,256059356,0.000696932
41,82,3362,181818,256059356,0.000710062
42,63,2646,184464,256059356,0.000720395
43,87,3741,188205,256059356,0.000735005
44,71,3124,191329,256059356,0.000747206
45,100,4500,195829,256059356,0.00076478
46,75,3450,199279,256059356,0.000778253
47,67,3149,202428,256059356,0.000790551
48,68,3264,205692,256059356,0.000803298
49,94,4606,210298,256059356,0.000821286
50,74,3700,213998,256059356,0.000835736
51,70,3570,217568,256059356,0.000849678
52,64,3328,220896,256059356,0.000862675
53,61,3233,224129,256059356,0.000875301
54,44,2376,226505,256059356,0.00088458
55,59,3245,229750,256059356,0.000897253
56,74,4144,233894,256059356,0.000913437
57,47,2679,236573,256059356,0.000923899
58,68,3944,240517,256059356,0.000939302
59,62,3658,244175,256059356,0.000953587
60,70,4200,248375,256059356,0.00096999
61,59,3599,251974,256059356,0.000984045
62,59,3658,255632,256059356,0.000998331
63,53,3339,258971,256059356,0.00101137
64,52,3328,262299,256059356,0.00102437
65,65,4225,266524,256059356,0.00104087
66,66,4356,270880,256059356,0.00105788
67,50,3350,274230,256059356,0.00107096
68,56,3808,278038,256059356,0.00108583
69,41,2829,280867,256059356,0.00109688
70,42,2940,283807,256059356,0.00110836
71,78,5538,289345,256059356,0.00112999
72,36,2592,291937,256059356,0.00114011
73,63,4599,296536,256059356,0.00115808
74,56,4144,300680,256059356,0.00117426
75,39,2925,303605,256059356,0.00118568
76,37,2812,306417,256059356,0.00119666
77,37,2849,309266,256059356,0.00120779
78,40,3120,312386,256059356,0.00121997
79,41,3239,315625,256059356,0.00123262
80,53,4240,319865,256059356,0.00124918
81,41,3321,323186,256059356,0.00126215
82,41,3362,326548,256059356,0.00127528
83,58,4814,331362,256059356,0.00129408
84,31,2604,333966,256059356,0.00130425
85,37,3145,337111,256059356,0.00131653
86,51,4386,341497,256059356,0.00133366
87,50,4350,345847,256059356,0.00135065
88,37,3256,349103,256059356,0.00136337
89,37,3293,352396,256059356,0.00137623
90,31,2790,355186,256059356,0.00138712
91,35,3185,358371,256059356,0.00139956
92,33,3036,361407,256059356,0.00141142
93,27,2511,363918,256059356,0.00142123
94,33,3102,367020,256059356,0.00143334
95,47,4465,371485,256059356,0.00145078
96,36,3456,374941,256059356,0.00146427
97,46,4462,379403,256059356,0.0014817
98,18,1764,381167,256059356,0.00148859
99,26,2574,383741,256059356,0.00149864
100,32,3200,386941,256059356,0.00151114
101,21,2121,389062,256059356,0.00151942
102,36,3672,392734,256059356,0.00153376
103,33,3399,396133,256059356,0.00154704
104,24,2496,398629,256059356,0.00155678
105,22,2310,400939,256059356,0.0015658
106,18,1908,402847,256059356,0.00157326
107,23,2461,405308,256059356,0.00158287
108,33,3564,408872,256059356,0.00159679
109,32,3488,412360,256059356,0.00161041
110,28,3080,415440,256059356,0.00162244
111,12,1332,416772,256059356,0.00162764
112,24,2688,419460,256059356,0.00163814
113,19,2147,421607,256059356,0.00164652
114,12,1368,422975,256059356,0.00165186
115,29,3335,426310,256059356,0.00166489
116,18,2088,428398,256059356,0.00167304
117,20,2340,430738,256059356,0.00168218
118,27,3186,433924,256059356,0.00169462
119,24,2856,436780,256059356,0.00170578
120,29,3480,440260,256059356,0.00171937
121,21,2541,442801,256059356,0.00172929
122,23,2806,445607,256059356,0.00174025
123,41,5043,450650,256059356,0.00175994
124,26,3224,453874,256059356,0.00177253
125,22,2750,456624,256059356,0.00178327
126,15,1890,458514,256059356,0.00179066
127,11,1397,459911,256059356,0.00179611
128,22,2816,462727,256059356,0.00180711
129,34,4386,467113,256059356,0.00182424
130,28,3640,470753,256059356,0.00183845
131,31,4061,474814,256059356,0.00185431
132,13,1716,476530,256059356,0.00186101
133,21,2793,479323,256059356,0.00187192
134,21,2814,482137,256059356,0.00188291
135,15,2025,484162,256059356,0.00189082
136,22,2992,487154,256059356,0.0019025
137,19,2603,489757,256059356,0.00191267
138,24,3312,493069,256059356,0.0019256
139,17,2363,495432,256059356,0.00193483
140,31,4340,499772,256059356,0.00195178
141,17,2397,502169,256059356,0.00196114
142,26,3692,505861,256059356,0.00197556
143,33,4719,510580,256059356,0.00199399
144,19,2736,513316,256059356,0.00200468
145,25,3625,516941,256059356,0.00201883
146,20,2920,519861,256059356,0.00203024
147,25,3675,523536,256059356,0.00204459
148,11,1628,525164,256059356,0.00205095
149,15,2235,527399,256059356,0.00205967
150,14,2100,529499,256059356,0.00206788
151,12,1812,531311,256059356,0.00207495
152,12,1824,533135,256059356,0.00208208
153,18,2754,535889,256059356,0.00209283
154,11,1694,537583,256059356,0.00209945
155,22,3410,540993,256059356,0.00211276
156,28,4368,545361,256059356,0.00212982
157,27,4239,549600,256059356,0.00214638
158,12,1896,551496,256059356,0.00215378
159,10,1590,553086,256059356,0.00215999
160,19,3040,556126,256059356,0.00217186
161,29,4669,560795,256059356,0.0021901
162,19,3078,563873,256059356,0.00220212
163,17,2771,566644,256059356,0.00221294
164,22,3608,570252,256059356,0.00222703
165,12,1980,572232,256059356,0.00223476
166,20,3320,575552,256059356,0.00224773
167,24,4008,579560,256059356,0.00226338
168,22,3696,583256,256059356,0.00227782
169,16,2704,585960,256059356,0.00228838
170,14,2380,588340,256059356,0.00229767
171,31,5301,593641,256059356,0.00231837
172,12,2064,595705,256059356,0.00232643
173,16,2768,598473,256059356,0.00233724
174,27,4698,603171,256059356,0.00235559
175,23,4025,607196,256059356,0.00237131
176,22,3872,611068,256059356,0.00238643
177,12,2124,613192,256059356,0.00239473
178,23,4094,617286,256059356,0.00241071
179,18,3222,620508,256059356,0.0024233
180,17,3060,623568,256059356,0.00243525
181,9,1629,625197,256059356,0.00244161
182,12,2184,627381,256059356,0.00245014
183,12,2196,629577,256059356,0.00245872
184,22,4048,633625,256059356,0.00247452
185,17,3145,636770,256059356,0.00248681
186,21,3906,640676,256059356,0.00250206
187,13,2431,643107,256059356,0.00251155
188,14,2632,645739,256059356,0.00252183
189,18,3402,649141,256059356,0.00253512
190,8,1520,650661,256059356,0.00254106
191,13,2483,653144,256059356,0.00255075
192,22,4224,657368,256059356,0.00256725
193,22,4246,661614,256059356,0.00258383
194,11,2134,663748,256059356,0.00259216
195,16,3120,666868,256059356,0.00260435
196,19,3724,670592,256059356,0.00261889
197,14,2758,673350,256059356,0.00262966
198,12,2376,675726,256059356,0.00263894
199,12,2388,678114,256059356,0.00264827
200,9,1800,679914,256059356,0.0026553
201,15,3015,682929,256059356,0.00266707
202,23,4646,687575,256059356,0.00268522
203,10,2030,689605,256059356,0.00269315
204,4,816,690421,256059356,0.00269633
205,9,1845,692266,256059356,0.00270354
206,11,2266,694532,256059356,0.00271239
207,4,828,695360,256059356,0.00271562
208,6,1248,696608,256059356,0.00272049
209,7,1463,698071,256059356,0.00272621
210,20,4200,702271,256059356,0.00274261
211,12,2532,704803,256059356,0.0027525
212,10,2120,706923,256059356,0.00276078
213,6,1278,708201,256059356,0.00276577
214,10,2140,710341,256059356,0.00277413
215,12,2580,712921,256059356,0.0027842
216,14,3024,715945,256059356,0.00279601
217,16,3472,719417,256059356,0.00280957
218,16,3488,722905,256059356,0.00282319
219,8,1752,724657,256059356,0.00283004
220,16,3520,728177,256059356,0.00284378
221,10,2210,730387,256059356,0.00285241
222,5,1110,731497,256059356,0.00285675
223,12,2676,734173,256059356,0.0028672
224,19,4256,738429,256059356,0.00288382
225,18,4050,742479,256059356,0.00289964
226,11,2486,744965,256059356,0.00290934
227,17,3859,748824,256059356,0.00292442
228,9,2052,750876,256059356,0.00293243
229,8,1832,752708,256059356,0.00293958
230,5,1150,753858,256059356,0.00294408
231,11,2541,756399,256059356,0.002954
232,16,3712,760111,256059356,0.0029685
233,1,233,760344,256059356,0.00296941
234,12,2808,763152,256059356,0.00298037
235,17,3995,767147,256059356,0.00299597
236,10,2360,769507,256059356,0.00300519
237,17,4029,773536,256059356,0.00302092
238,13,3094,776630,256059356,0.00303301
239,14,3346,779976,256059356,0.00304607
240,5,1200,781176,256059356,0.00305076
241,9,2169,783345,256059356,0.00305923
242,8,1936,785281,256059356,0.00306679
243,7,1701,786982,256059356,0.00307344
244,18,4392,791374,256059356,0.00309059
245,22,5390,796764,256059356,0.00311164
246,5,1230,797994,256059356,0.00311644
247,6,1482,799476,256059356,0.00312223
248,13,3224,802700,256059356,0.00313482
249,7,1743,804443,256059356,0.00314163
250,14,3500,807943,256059356,0.0031553
251,8,2008,809951,256059356,0.00316314
252,9,2268,812219,256059356,0.003172
253,8,2024,814243,256059356,0.0031799
254,6,1524,815767,256059356,0.00318585
255,19,4845,820612,256059356,0.00320477
256,5,1280,821892,256059356,0.00320977
257,14,3598,825490,256059356,0.00322382
258,11,2838,828328,256059356,0.00323491
259,18,4662,832990,256059356,0.00325311
260,11,2860,835850,256059356,0.00326428
261,15,3915,839765,256059356,0.00327957
262,4,1048,840813,256059356,0.00328366
263,9,2367,843180,256059356,0.00329291
264,5,1320,844500,256059356,0.00329806
265,13,3445,847945,256059356,0.00331152
266,11,2926,850871,256059356,0.00332294
267,5,1335,852206,256059356,0.00332816
268,8,2144,854350,256059356,0.00333653
269,17,4573,858923,256059356,0.00335439
270,8,2160,861083,256059356,0.00336283
271,8,2168,863251,256059356,0.00337129
272,7,1904,865155,256059356,0.00337873
273,12,3276,868431,256059356,0.00339152
274,6,1644,870075,256059356,0.00339794
275,6,1650,871725,256059356,0.00340439
276,6,1656,873381,256059356,0.00341085
277,7,1939,875320,256059356,0.00341843
278,13,3614,878934,256059356,0.00343254
279,11,3069,882003,256059356,0.00344453
280,13,3640,885643,256059356,0.00345874
281,4,1124,886767,256059356,0.00346313
282,9,2538,889305,256059356,0.00347304
283,8,2264,891569,256059356,0.00348188
284,2,568,892137,256059356,0.0034841
285,6,1710,893847,256059356,0.00349078
286,15,4290,898137,256059356,0.00350753
287,4,1148,899285,256059356,0.00351202
288,9,2592,901877,256059356,0.00352214
289,9,2601,904478,256059356,0.0035323
290,4,1160,905638,256059356,0.00353683
291,10,2910,908548,256059356,0.00354819
292,16,4672,913220,256059356,0.00356644
293,3,879,914099,256059356,0.00356987
294,11,3234,917333,256059356,0.0035825
295,9,2655,919988,256059356,0.00359287
296,6,1776,921764,256059356,0.00359981
297,5,1485,923249,256059356,0.00360561
298,13,3874,927123,256059356,0.00362073
299,2,598,927721,256059356,0.00362307
300,6,1800,929521,256059356,0.0036301
301,9,2709,932230,256059356,0.00364068
302,9,2718,934948,256059356,0.00365129
303,13,3939,938887,256059356,0.00366668
304,6,1824,940711,256059356,0.0036738
305,9,2745,943456,256059356,0.00368452
306,7,2142,945598,256059356,0.00369289
307,12,3684,949282,256059356,0.00370727
308,9,2772,952054,256059356,0.0037181
309,3,927,952981,256059356,0.00372172
310,3,930,953911,256059356,0.00372535
311,4,1244,955155,256059356,0.00373021
312,16,4992,960147,256059356,0.0037497
313,12,3756,963903,256059356,0.00376437
314,1,314,964217,256059356,0.0037656
315,5,1575,965792,256059356,0.00377175
316,7,2212,968004,256059356,0.00378039
317,6,1902,969906,256059356,0.00378782
318,5,1590,971496,256059356,0.00379403
319,7,2233,973729,256059356,0.00380275
320,11,3520,977249,256059356,0.00381649
321,5,1605,978854,256059356,0.00382276
322,7,2254,981108,256059356,0.00383156
323,2,646,981754,256059356,0.00383409
324,11,3564,985318,256059356,0.00384801
325,7,2275,987593,256059356,0.00385689
326,5,1630,989223,256059356,0.00386326
327,9,2943,992166,256059356,0.00387475
328,4,1312,993478,256059356,0.00387987
329,1,329,993807,256059356,0.00388116
330,11,3630,997437,256059356,0.00389534
331,8,2648,1000085,256059356,0.00390568
332,5,1660,1001745,256059356,0.00391216
333,2,666,1002411,256059356,0.00391476
334,3,1002,1003413,256059356,0.00391867
335,7,2345,1005758,256059356,0.00392783
336,9,3024,1008782,256059356,0.00393964
337,2,674,1009456,256059356,0.00394227
338,5,1690,1011146,256059356,0.00394887
339,5,1695,1012841,256059356,0.00395549
340,8,2720,1015561,256059356,0.00396612
341,5,1705,1017266,256059356,0.00397277
342,5,1710,1018976,256059356,0.00397945
343,5,1715,1020691,256059356,0.00398615
345,8,2760,1023451,256059356,0.00399693
346,6,2076,1025527,256059356,0.00400504
347,8,2776,1028303,256059356,0.00401588
348,6,2088,1030391,256059356,0.00402403
349,7,2443,1032834,256059356,0.00403357
350,14,4900,1037734,256059356,0.00405271
351,11,3861,1041595,256059356,0.00406779
352,11,3872,1045467,256059356,0.00408291
353,9,3177,1048644,256059356,0.00409532
354,9,3186,1051830,256059356,0.00410776
355,3,1065,1052895,256059356,0.00411192
356,5,1780,1054675,256059356,0.00411887
357,1,357,1055032,256059356,0.00412026
358,5,1790,1056822,256059356,0.00412725
359,5,1795,1058617,256059356,0.00413426
360,8,2880,1061497,256059356,0.00414551
361,8,2888,1064385,256059356,0.00415679
362,4,1448,1065833,256059356,0.00416245
363,8,2904,1068737,256059356,0.00417379
364,4,1456,1070193,256059356,0.00417947
365,10,3650,1073843,256059356,0.00419373
366,5,1830,1075673,256059356,0.00420087
367,6,2202,1077875,256059356,0.00420947
368,6,2208,1080083,256059356,0.0042181
369,5,1845,1081928,256059356,0.0042253
370,10,3700,1085628,256059356,0.00423975
371,1,371,1085999,256059356,0.0042412
372,10,3720,1089719,256059356,0.00425573
373,13,4849,1094568,256059356,0.00427467
374,5,1870,1096438,256059356,0.00428197
375,1,375,1096813,256059356,0.00428343
376,4,1504,1098317,256059356,0.00428931
377,1,377,1098694,256059356,0.00429078
378,6,2268,1100962,256059356,0.00429964
379,9,3411,1104373,256059356,0.00431296
380,14,5320,1109693,256059356,0.00433373
381,9,3429,1113122,256059356,0.00434712
382,5,1910,1115032,256059356,0.00435458
383,1,383,1115415,256059356,0.00435608
384,6,2304,1117719,256059356,0.00436508
385,7,2695,1120414,256059356,0.0043756
386,2,772,1121186,256059356,0.00437862
387,5,1935,1123121,256059356,0.00438617
388,8,3104,1126225,256059356,0.0043983
389,8,3112,1129337,256059356,0.00441045
390,2,780,1130117,256059356,0.0044135
391,2,782,1130899,256059356,0.00441655
392,5,1960,1132859,256059356,0.0044242
393,2,786,1133645,256059356,0.00442727
394,1,394,1134039,256059356,0.00442881
395,2,790,1134829,256059356,0.0044319
396,8,3168,1137997,256059356,0.00444427
397,7,2779,1140776,256059356,0.00445512
398,8,3184,1143960,256059356,0.00446756
399,2,798,1144758,256059356,0.00447067
400,3,1200,1145958,256059356,0.00447536
402,10,4020,1149978,256059356,0.00449106
403,17,6851,1156829,256059356,0.00451782
404,7,2828,1159657,256059356,0.00452886
405,5,2025,1161682,256059356,0.00453677
406,8,3248,1164930,256059356,0.00454945
407,4,1628,1166558,256059356,0.00455581
408,4,1632,1168190,256059356,0.00456218
409,1,409,1168599,256059356,0.00456378
410,6,2460,1171059,256059356,0.00457339
411,6,2466,1173525,256059356,0.00458302
412,6,2472,1175997,256059356,0.00459267
413,4,1652,1177649,256059356,0.00459913
414,4,1656,1179305,256059356,0.00460559
415,7,2905,1182210,256059356,0.00461694
416,8,3328,1185538,256059356,0.00462993
417,1,417,1185955,256059356,0.00463156
418,3,1254,1187209,256059356,0.00463646
419,4,1676,1188885,256059356,0.00464301
420,8,3360,1192245,256059356,0.00465613
421,6,2526,1194771,256059356,0.00466599
423,10,4230,1199001,256059356,0.00468251
424,8,3392,1202393,256059356,0.00469576
426,1,426,1202819,256059356,0.00469742
427,10,4270,1207089,256059356,0.0047141
428,1,428,1207517,256059356,0.00471577
429,1,429,1207946,256059356,0.00471745
430,3,1290,1209236,256059356,0.00472248
431,3,1293,1210529,256059356,0.00472753
432,5,2160,1212689,256059356,0.00473597
433,2,866,1213555,256059356,0.00473935
434,5,2170,1215725,256059356,0.00474782
435,1,435,1216160,256059356,0.00474952
436,5,2180,1218340,256059356,0.00475804
437,7,3059,1221399,256059356,0.00476998
438,3,1314,1222713,256059356,0.00477512
440,2,880,1223593,256059356,0.00477855
441,4,1764,1225357,256059356,0.00478544
442,2,884,1226241,256059356,0.00478889
443,5,2215,1228456,256059356,0.00479754
444,8,3552,1232008,256059356,0.00481142
445,13,5785,1237793,256059356,0.00483401
446,5,2230,1240023,256059356,0.00484272
447,4,1788,1241811,256059356,0.0048497
448,5,2240,1244051,256059356,0.00485845
449,6,2694,1246745,256059356,0.00486897
450,5,2250,1248995,256059356,0.00487776
451,4,1804,1250799,256059356,0.0048848
452,3,1356,1252155,256059356,0.0048901
453,1,453,1252608,256059356,0.00489187
454,2,908,1253516,256059356,0.00489541
455,4,1820,1255336,256059356,0.00490252
456,2,912,1256248,256059356,0.00490608
457,3,1371,1257619,256059356,0.00491144
458,3,1374,1258993,256059356,0.0049168
460,5,2300,1261293,256059356,0.00492578
461,2,922,1262215,256059356,0.00492938
462,2,924,1263139,256059356,0.00493299
463,10,4630,1267769,256059356,0.00495107
464,10,4640,1272409,256059356,0.0049692
465,9,4185,1276594,256059356,0.00498554
466,2,932,1277526,256059356,0.00498918
467,3,1401,1278927,256059356,0.00499465
468,4,1872,1280799,256059356,0.00500196
469,4,1876,1282675,256059356,0.00500929
470,1,470,1283145,256059356,0.00501112
471,7,3297,1286442,256059356,0.005024
472,1,472,1286914,256059356,0.00502584
473,10,4730,1291644,256059356,0.00504431
474,4,1896,1293540,256059356,0.00505172
475,6,2850,1296390,256059356,0.00506285
477,6,2862,1299252,256059356,0.00507403
478,1,478,1299730,256059356,0.00507589
479,4,1916,1301646,256059356,0.00508338
480,7,3360,1305006,256059356,0.0050965
482,4,1928,1306934,256059356,0.00510403
483,3,1449,1308383,256059356,0.00510969
484,1,484,1308867,256059356,0.00511158
485,4,1940,1310807,256059356,0.00511915
486,3,1458,1312265,256059356,0.00512485
487,4,1948,1314213,256059356,0.00513245
488,7,3416,1317629,256059356,0.0051458
489,3,1467,1319096,256059356,0.00515152
490,3,1470,1320566,256059356,0.00515727
491,6,2946,1323512,256059356,0.00516877
492,4,1968,1325480,256059356,0.00517646
493,5,2465,1327945,256059356,0.00518608
494,9,4446,1332391,256059356,0.00520345
496,4,1984,1334375,256059356,0.00521119
497,11,5467,1339842,256059356,0.00523254
498,4,1992,1341834,256059356,0.00524032
499,4,1996,1343830,256059356,0.00524812
500,8,4000,1347830,256059356,0.00526374
501,2,1002,1348832,256059356,0.00526765
502,9,4518,1353350,256059356,0.0052853
503,1,503,1353853,256059356,0.00528726
504,2,1008,1354861,256059356,0.0052912
505,10,5050,1359911,256059356,0.00531092
506,4,2024,1361935,256059356,0.00531883
507,2,1014,1362949,256059356,0.00532279
508,8,4064,1367013,256059356,0.00533866
509,2,1018,1368031,256059356,0.00534263
510,4,2040,1370071,256059356,0.0053506
511,9,4599,1374670,256059356,0.00536856
512,2,1024,1375694,256059356,0.00537256
513,4,2052,1377746,256059356,0.00538057
514,6,3084,1380830,256059356,0.00539262
515,9,4635,1385465,256059356,0.00541072
516,5,2580,1388045,256059356,0.00542079
517,13,6721,1394766,256059356,0.00544704
518,7,3626,1398392,256059356,0.0054612
519,2,1038,1399430,256059356,0.00546526
520,14,7280,1406710,256059356,0.00549369
521,3,1563,1408273,256059356,0.00549979
522,3,1566,1409839,256059356,0.00550591
523,5,2615,1412454,256059356,0.00551612
524,2,1048,1413502,256059356,0.00552021
525,3,1575,1415077,256059356,0.00552636
526,8,4208,1419285,256059356,0.0055428
527,9,4743,1424028,256059356,0.00556132
528,3,1584,1425612,256059356,0.00556751
529,3,1587,1427199,256059356,0.0055737
530,1,530,1427729,256059356,0.00557577
532,3,1596,1429325,256059356,0.00558201
533,4,2132,1431457,256059356,0.00559033
534,2,1068,1432525,256059356,0.0055945
535,4,2140,1434665,256059356,0.00560286
536,1,536,1435201,256059356,0.00560495
537,5,2685,1437886,256059356,0.00561544
538,2,1076,1438962,256059356,0.00561964
539,2,1078,1440040,256059356,0.00562385
540,1,540,1440580,256059356,0.00562596
541,2,1082,1441662,256059356,0.00563019
542,7,3794,1445456,256059356,0.005645
543,1,543,1445999,256059356,0.00564712
544,3,1632,1447631,256059356,0.0056535
545,4,2180,1449811,256059356,0.00566201
546,9,4914,1454725,256059356,0.0056812
548,3,1644,1456369,256059356,0.00568762
549,4,2196,1458565,256059356,0.0056962
550,5,2750,1461315,256059356,0.00570694
551,3,1653,1462968,256059356,0.00571339
552,1,552,1463520,256059356,0.00571555
553,5,2765,1466285,256059356,0.00572635
554,15,8310,1474595,256059356,0.0057588
555,4,2220,1476815,256059356,0.00576747
556,1,556,1477371,256059356,0.00576964
558,7,3906,1481277,256059356,0.0057849
559,10,5590,1486867,256059356,0.00580673
560,5,2800,1489667,256059356,0.00581766
561,3,1683,1491350,256059356,0.00582424
562,5,2810,1494160,256059356,0.00583521
563,4,2252,1496412,256059356,0.005844
564,2,1128,1497540,256059356,0.00584841
565,1,565,1498105,256059356,0.00585062
566,5,2830,1500935,256059356,0.00586167
567,3,1701,1502636,256059356,0.00586831
568,4,2272,1504908,256059356,0.00587718
569,8,4552,1509460,256059356,0.00589496
570,7,3990,1513450,256059356,0.00591054
571,3,1713,1515163,256059356,0.00591723
572,3,1716,1516879,256059356,0.00592394
573,7,4011,1520890,256059356,0.0059396
574,5,2870,1523760,256059356,0.00595081
576,1,576,1524336,256059356,0.00595306
578,12,6936,1531272,256059356,0.00598014
579,5,2895,1534167,256059356,0.00599145
580,8,4640,1538807,256059356,0.00600957
581,2,1162,1539969,256059356,0.00601411
582,5,2910,1542879,256059356,0.00602547
584,1,584,1543463,256059356,0.00602775
585,1,585,1544048,256059356,0.00603004
586,4,2344,1546392,256059356,0.00603919
587,3,1761,1548153,256059356,0.00604607
588,2,1176,1549329,256059356,0.00605066
589,2,1178,1550507,256059356,0.00605526
590,12,7080,1557587,256059356,0.00608291
591,3,1773,1559360,256059356,0.00608984
592,5,2960,1562320,256059356,0.0061014
593,7,4151,1566471,256059356,0.00611761
594,1,594,1567065,256059356,0.00611993
595,4,2380,1569445,256059356,0.00612922
596,6,3576,1573021,256059356,0.00614319
597,3,1791,1574812,256059356,0.00615018
598,5,2990,1577802,256059356,0.00616186
599,7,4193,1581995,256059356,0.00617824
602,2,1204,1583199,256059356,0.00618294
604,13,7852,1591051,256059356,0.0062136
605,2,1210,1592261,256059356,0.00621833
606,1,606,1592867,256059356,0.00622069
607,1,607,1593474,256059356,0.00622306
609,2,1218,1594692,256059356,0.00622782
611,3,1833,1596525,256059356,0.00623498
612,4,2448,1598973,256059356,0.00624454
613,5,3065,1602038,256059356,0.00625651
614,3,1842,1603880,256059356,0.0062637
615,2,1230,1605110,256059356,0.00626851
616,3,1848,1606958,256059356,0.00627572
617,9,5553,1612511,256059356,0.00629741
618,4,2472,1614983,256059356,0.00630706
619,8,4952,1619935,256059356,0.0063264
620,2,1240,1621175,256059356,0.00633125
621,4,2484,1623659,256059356,0.00634095
622,2,1244,1624903,256059356,0.00634581
623,3,1869,1626772,256059356,0.00635311
624,6,3744,1630516,256059356,0.00636773
626,3,1878,1632394,256059356,0.00637506
627,1,627,1633021,256059356,0.00637751
628,1,628,1633649,256059356,0.00637996
629,4,2516,1636165,256059356,0.00638979
630,5,3150,1639315,256059356,0.00640209
631,3,1893,1641208,256059356,0.00640948
633,3,1899,1643107,256059356,0.0064169
634,3,1902,1645009,256059356,0.00642433
635,1,635,1645644,256059356,0.00642681
636,2,1272,1646916,256059356,0.00643177
637,2,1274,1648190,256059356,0.00643675
638,3,1914,1650104,256059356,0.00644422
639,5,3195,1653299,256059356,0.0064567
640,1,640,1653939,256059356,0.0064592
641,3,1923,1655862,256059356,0.00646671
642,1,642,1656504,256059356,0.00646922
643,1,643,1657147,256059356,0.00647173
644,8,5152,1662299,256059356,0.00649185
645,1,645,1662944,256059356,0.00649437
646,4,2584,1665528,256059356,0.00650446
647,2,1294,1666822,256059356,0.00650951
648,4,2592,1669414,256059356,0.00651964
649,1,649,1670063,256059356,0.00652217
650,2,1300,1671363,256059356,0.00652725
652,1,652,1672015,256059356,0.00652979
654,2,1308,1673323,256059356,0.0065349
655,1,655,1673978,256059356,0.00653746
656,2,1312,1675290,256059356,0.00654258
657,6,3942,1679232,256059356,0.00655798
659,3,1977,1681209,256059356,0.0065657
660,5,3300,1684509,256059356,0.00657859
661,2,1322,1685831,256059356,0.00658375
662,6,3972,1689803,256059356,0.00659926
663,2,1326,1691129,256059356,0.00660444
665,3,1995,1693124,256059356,0.00661223
666,4,2664,1695788,256059356,0.00662264
667,1,667,1696455,256059356,0.00662524
668,7,4676,1701131,256059356,0.0066435
669,1,669,1701800,256059356,0.00664612
670,1,670,1702470,256059356,0.00664873
671,2,1342,1703812,256059356,0.00665397
672,2,1344,1705156,256059356,0.00665922
673,2,1346,1706502,256059356,0.00666448
674,3,2022,1708524,256059356,0.00667237
675,2,1350,1709874,256059356,0.00667765
677,4,2708,1712582,256059356,0.00668822
680,2,1360,1713942,256059356,0.00669353
681,2,1362,1715304,256059356,0.00669885
682,5,3410,1718714,256059356,0.00671217
683,5,3415,1722129,256059356,0.00672551
684,2,1368,1723497,256059356,0.00673085
685,2,1370,1724867,256059356,0.0067362
687,3,2061,1726928,256059356,0.00674425
689,2,1378,1728306,256059356,0.00674963
690,1,690,1728996,256059356,0.00675233
692,2,1384,1730380,256059356,0.00675773
693,3,2079,1732459,256059356,0.00676585
694,1,694,1733153,256059356,0.00676856
695,3,2085,1735238,256059356,0.0067767
696,1,696,1735934,256059356,0.00677942
697,1,697,1736631,256059356,0.00678214
698,3,2094,1738725,256059356,0.00679032
699,1,699,1739424,256059356,0.00679305
700,1,700,1740124,256059356,0.00679578
701,1,701,1740825,256059356,0.00679852
702,1,702,1741527,256059356,0.00680126
703,5,3515,1745042,256059356,0.00681499
704,2,1408,1746450,256059356,0.00682049
705,3,2115,1748565,256059356,0.00682875
707,4,2828,1751393,256059356,0.00683979
708,1,708,1752101,256059356,0.00684256
709,12,8508,1760609,256059356,0.00687578
710,1,710,1761319,256059356,0.00687856
711,3,2133,1763452,256059356,0.00688689
712,2,1424,1764876,256059356,0.00689245
715,1,715,1765591,256059356,0.00689524
716,2,1432,1767023,256059356,0.00690083
717,3,2151,1769174,256059356,0.00690923
718,4,2872,1772046,256059356,0.00692045
719,2,1438,1773484,256059356,0.00692607
720,6,4320,1777804,256059356,0.00694294
722,1,722,1778526,256059356,0.00694576
723,2,1446,1779972,256059356,0.0069514
724,3,2172,1782144,256059356,0.00695989
725,2,1450,1783594,256059356,0.00696555
726,5,3630,1787224,256059356,0.00697973
727,10,7270,1794494,256059356,0.00700812
728,4,2912,1797406,256059356,0.00701949
729,8,5832,1803238,256059356,0.00704227
730,5,3650,1806888,256059356,0.00705652
731,5,3655,1810543,256059356,0.00707079
732,5,3660,1814203,256059356,0.00708509
735,6,4410,1818613,256059356,0.00710231
736,4,2944,1821557,256059356,0.00711381
737,1,737,1822294,256059356,0.00711669
738,6,4428,1826722,256059356,0.00713398
739,1,739,1827461,256059356,0.00713686
740,5,3700,1831161,256059356,0.00715131
741,10,7410,1838571,256059356,0.00718025
742,2,1484,1840055,256059356,0.00718605
743,3,2229,1842284,256059356,0.00719475
744,1,744,1843028,256059356,0.00719766
745,6,4470,1847498,256059356,0.00721512
746,5,3730,1851228,256059356,0.00722968
747,2,1494,1852722,256059356,0.00723552
748,5,3740,1856462,256059356,0.00725012
749,1,749,1857211,256059356,0.00725305
750,1,750,1857961,256059356,0.00725598
751,2,1502,1859463,256059356,0.00726184
752,5,3760,1863223,256059356,0.00727653
753,4,3012,1866235,256059356,0.00728829
754,2,1508,1867743,256059356,0.00729418
756,2,1512,1869255,256059356,0.00730008
757,5,3785,1873040,256059356,0.00731487
758,1,758,1873798,256059356,0.00731783
759,1,759,1874557,256059356,0.00732079
760,2,1520,1876077,256059356,0.00732673
761,5,3805,1879882,256059356,0.00734159
762,3,2286,1882168,256059356,0.00735051
763,3,2289,1884457,256059356,0.00735945
764,6,4584,1889041,256059356,0.00737736
765,6,4590,1893631,256059356,0.00739528
766,2,1532,1895163,256059356,0.00740126
767,2,1534,1896697,256059356,0.00740726
768,3,2304,1899001,256059356,0.00741625
769,1,769,1899770,256059356,0.00741926
770,5,3850,1903620,256059356,0.00743429
771,5,3855,1907475,256059356,0.00744935
772,5,3860,1911335,256059356,0.00746442
773,2,1546,1912881,256059356,0.00747046
774,11,8514,1921395,256059356,0.00750371
775,3,2325,1923720,256059356,0.00751279
776,4,3104,1926824,256059356,0.00752491
777,1,777,1927601,256059356,0.00752795
778,3,2334,1929935,256059356,0.00753706
779,2,1558,1931493,256059356,0.00754315
780,7,5460,1936953,256059356,0.00756447
781,2,1562,1938515,256059356,0.00757057
782,4,3128,1941643,256059356,0.00758278
783,1,783,1942426,256059356,0.00758584
784,3,2352,1944778,256059356,0.00759503
785,3,2355,1947133,256059356,0.00760423
786,1,786,1947919,256059356,0.00760729
787,4,3148,1951067,256059356,0.00761959
788,3,2364,1953431,256059356,0.00762882
789,2,1578,1955009,256059356,0.00763498
790,5,3950,1958959,256059356,0.00765041
791,3,2373,1961332,256059356,0.00765968
792,2,1584,1962916,256059356,0.00766586
793,2,1586,1964502,256059356,0.00767206
796,1,796,1965298,256059356,0.00767517
797,2,1594,1966892,256059356,0.00768139
798,2,1596,1968488,256059356,0.00768762
799,2,1598,1970086,256059356,0.00769386
800,4,3200,1973286,256059356,0.00770636
802,10,8020,1981306,256059356,0.00773768
803,2,1606,1982912,256059356,0.00774395
804,2,1608,1984520,256059356,0.00775023
805,1,805,1985325,256059356,0.00775338
806,3,2418,1987743,256059356,0.00776282
807,2,1614,1989357,256059356,0.00776912
808,4,3232,1992589,256059356,0.00778175
809,1,809,1993398,256059356,0.00778491
810,3,2430,1995828,256059356,0.0077944
811,4,3244,1999072,256059356,0.00780706
812,2,1624,2000696,256059356,0.00781341
813,2,1626,2002322,256059356,0.00781976
814,1,814,2003136,256059356,0.00782294
815,4,3260,2006396,256059356,0.00783567
816,1,816,2007212,256059356,0.00783885
818,2,1636,2008848,256059356,0.00784524
819,7,5733,2014581,256059356,0.00786763
822,3,2466,2017047,256059356,0.00787726
823,5,4115,2021162,256059356,0.00789333
824,4,3296,2024458,256059356,0.00790621
825,2,1650,2026108,256059356,0.00791265
826,1,826,2026934,256059356,0.00791588
827,3,2481,2029415,256059356,0.00792556
828,4,3312,2032727,256059356,0.0079385
829,2,1658,2034385,256059356,0.00794497
830,4,3320,2037705,256059356,0.00795794
831,2,1662,2039367,256059356,0.00796443
832,5,4160,2043527,256059356,0.00798068
833,2,1666,2045193,256059356,0.00798718
834,3,2502,2047695,256059356,0.00799695
835,4,3340,2051035,256059356,0.00801
836,4,3344,2054379,256059356,0.00802306
837,3,2511,2056890,256059356,0.00803286
839,6,5034,2061924,256059356,0.00805252
840,5,4200,2066124,256059356,0.00806893
841,4,3364,2069488,256059356,0.00808206
842,1,842,2070330,256059356,0.00808535
843,7,5901,2076231,256059356,0.0081084
844,4,3376,2079607,256059356,0.00812158
845,1,845,2080452,256059356,0.00812488
847,7,5929,2086381,256059356,0.00814804
848,5,4240,2090621,256059356,0.0081646
849,1,849,2091470,256059356,0.00816791
850,1,850,2092320,256059356,0.00817123
851,5,4255,2096575,256059356,0.00818785
852,4,3408,2099983,256059356,0.00820116
854,4,3416,2103399,256059356,0.0082145
855,5,4275,2107674,256059356,0.00823119
856,4,3424,2111098,256059356,0.00824456
857,6,5142,2116240,256059356,0.00826465
859,4,3436,2119676,256059356,0.00827807
860,4,3440,2123116,256059356,0.0082915
861,5,4305,2127421,256059356,0.00830831
862,3,2586,2130007,256059356,0.00831841
863,2,1726,2131733,256059356,0.00832515
864,2,1728,2133461,256059356,0.0083319
865,2,1730,2135191,256059356,0.00833866
866,2,1732,2136923,256059356,0.00834542
867,2,1734,2138657,256059356,0.00835219
868,4,3472,2142129,256059356,0.00836575
869,2,1738,2143867,256059356,0.00837254
870,3,2610,2146477,256059356,0.00838273
871,1,871,2147348,256059356,0.00838613
872,1,872,2148220,256059356,0.00838954
873,1,873,2149093,256059356,0.00839295
875,1,875,2149968,256059356,0.00839637
876,2,1752,2151720,256059356,0.00840321
877,2,1754,2153474,256059356,0.00841006
878,1,878,2154352,256059356,0.00841349
879,2,1758,2156110,256059356,0.00842035
880,3,2640,2158750,256059356,0.00843066
881,2,1762,2160512,256059356,0.00843754
882,1,882,2161394,256059356,0.00844099
884,2,1768,2163162,256059356,0.00844789
885,3,2655,2165817,256059356,0.00845826
886,5,4430,2170247,256059356,0.00847556
887,6,5322,2175569,256059356,0.00849635
888,2,1776,2177345,256059356,0.00850328
889,3,2667,2180012,256059356,0.0085137
890,2,1780,2181792,256059356,0.00852065
892,1,892,2182684,256059356,0.00852413
893,5,4465,2187149,256059356,0.00854157
894,3,2682,2189831,256059356,0.00855204
895,2,1790,2191621,256059356,0.00855904
896,1,896,2192517,256059356,0.00856253
897,4,3588,2196105,256059356,0.00857655
898,2,1796,2197901,256059356,0.00858356
899,1,899,2198800,256059356,0.00858707
900,3,2700,2201500,256059356,0.00859762
901,2,1802,2203302,256059356,0.00860465
902,6,5412,2208714,256059356,0.00862579
906,1,906,2209620,256059356,0.00862933
908,4,3632,2213252,256059356,0.00864351
909,2,1818,2215070,256059356,0.00865061
910,3,2730,2217800,256059356,0.00866127
911,1,911,2218711,256059356,0.00866483
913,1,913,2219624,256059356,0.0086684
915,1,915,2220539,256059356,0.00867197
916,3,2748,2223287,256059356,0.0086827
917,4,3668,2226955,256059356,0.00869703
918,4,3672,2230627,256059356,0.00871137
919,6,5514,2236141,256059356,0.0087329
920,2,1840,2237981,256059356,0.00874009
921,1,921,2238902,256059356,0.00874368
923,1,923,2239825,256059356,0.00874729
925,1,925,2240750,256059356,0.0087509
927,1,927,2241677,256059356,0.00875452
929,1,929,2242606,256059356,0.00875815
931,3,2793,2245399,256059356,0.00876906
933,3,2799,2248198,256059356,0.00877999
934,1,934,2249132,256059356,0.00878364
935,5,4675,2253807,256059356,0.00880189
936,1,936,2254743,256059356,0.00880555
937,1,937,2255680,256059356,0.00880921
938,1,938,2256618,256059356,0.00881287
939,2,1878,2258496,256059356,0.0088202
940,1,940,2259436,256059356,0.00882388
941,2,1882,2261318,256059356,0.00883123
942,2,1884,2263202,256059356,0.00883858
943,2,1886,2265088,256059356,0.00884595
944,1,944,2266032,256059356,0.00884964
945,5,4725,2270757,256059356,0.00886809
946,1,946,2271703,256059356,0.00887178
947,3,2841,2274544,256059356,0.00888288
948,5,4740,2279284,256059356,0.00890139
949,2,1898,2281182,256059356,0.0089088
955,1,955,2282137,256059356,0.00891253
957,1,957,2283094,256059356,0.00891627
958,1,958,2284052,256059356,0.00892001
959,2,1918,2285970,256059356,0.0089275
961,1,961,2286931,256059356,0.00893125
963,1,963,2287894,256059356,0.00893501
964,2,1928,2289822,256059356,0.00894254
965,2,1930,2291752,256059356,0.00895008
966,1,966,2292718,256059356,0.00895385
967,2,1934,2294652,256059356,0.00896141
968,2,1936,2296588,256059356,0.00896897
969,4,3876,2300464,256059356,0.0089841
970,2,1940,2302404,256059356,0.00899168
971,5,4855,2307259,256059356,0.00901064
973,4,3892,2311151,256059356,0.00902584
975,2,1950,2313101,256059356,0.00903346
976,2,1952,2315053,256059356,0.00904108
977,1,977,2316030,256059356,0.0090449
978,7,6846,2322876,256059356,0.00907163
979,4,3916,2326792,256059356,0.00908692
980,1,980,2327772,256059356,0.00909075
981,1,981,2328753,256059356,0.00909458
982,3,2946,2331699,256059356,0.00910609
985,1,985,2332684,256059356,0.00910993
986,1,986,2333670,256059356,0.00911379
987,3,2961,2336631,256059356,0.00912535
988,2,1976,2338607,256059356,0.00913307
990,3,2970,2341577,256059356,0.00914466
992,1,992,2342569,256059356,0.00914854
993,7,6951,2349520,256059356,0.00917569
994,3,2982,2352502,256059356,0.00918733
996,2,1992,2354494,256059356,0.00919511
998,1,998,2355492,256059356,0.00919901
999,1,999,2356491,256059356,0.00920291
1000,23,23000,2379491,256059356,0.00929273
1001,2,2002,2381493,256059356,0.00930055
1003,4,4012,2385505,256059356,0.00931622
1004,32,32128,2417633,256059356,0.00944169
1005,6,6030,2423663,256059356,0.00946524
1006,1,1006,2424669,256059356,0.00946917
1008,2,2016,2426685,256059356,0.00947704
1009,2,2018,2428703,256059356,0.00948492
1010,1,1010,2429713,256059356,0.00948887
1011,1,1011,2430724,256059356,0.00949281
1014,2,2028,2432752,256059356,0.00950073
1015,3,3045,2435797,256059356,0.00951263
1016,2,2032,2437829,256059356,0.00952056
1017,3,3051,2440880,256059356,0.00953248
1018,3,3054,2443934,256059356,0.0095444
1019,5,5095,2449029,256059356,0.0095643
1020,5,5100,2454129,256059356,0.00958422
1021,1,1021,2455150,256059356,0.00958821
1022,1,1022,2456172,256059356,0.0095922
1024,1,1024,2457196,256059356,0.0095962
1026,1,1026,2458222,256059356,0.0096002
1027,1,1027,2459249,256059356,0.00960421
1029,2,2058,2461307,256059356,0.00961225
1030,1,1030,2462337,256059356,0.00961627
1031,3,3093,2465430,256059356,0.00962835
1032,1,1032,2466462,256059356,0.00963238
1033,1,1033,2467495,256059356,0.00963642
1034,4,4136,2471631,256059356,0.00965257
1036,1,1036,2472667,256059356,0.00965662
1038,3,3114,2475781,256059356,0.00966878
1040,5,5200,2480981,256059356,0.00968909
1041,5,5205,2486186,256059356,0.00970941
1042,2,2084,2488270,256059356,0.00971755
1043,2,2086,2490356,256059356,0.0097257
1044,3,3132,2493488,256059356,0.00973793
1045,3,3135,2496623,256059356,0.00975017
1046,1,1046,2497669,256059356,0.00975426
1048,2,2096,2499765,256059356,0.00976244
1050,2,2100,2501865,256059356,0.00977064
1051,2,2102,2503967,256059356,0.00977885
1053,5,5265,2509232,256059356,0.00979942
1055,6,6330,2515562,256059356,0.00982414
1056,1,1056,2516618,256059356,0.00982826
1058,2,2116,2518734,256059356,0.00983652
1060,1,1060,2519794,256059356,0.00984066
1063,1,1063,2520857,256059356,0.00984482
1064,1,1064,2521921,256059356,0.00984897
1065,4,4260,2526181,256059356,0.00986561
1068,5,5340,2531521,256059356,0.00988646
1069,1,1069,2532590,256059356,0.00989064
1070,4,4280,2536870,256059356,0.00990735
1071,1,1071,2537941,256059356,0.00991153
1072,3,3216,2541157,256059356,0.00992409
1075,5,5375,2546532,256059356,0.00994508
1077,2,2154,2548686,256059356,0.0099535
1078,1,1078,2549764,256059356,0.00995771
1079,1,1079,2550843,256059356,0.00996192
1080,1,1080,2551923,256059356,0.00996614
1081,3,3243,2555166,256059356,0.0099788
1082,3,3246,2558412,256059356,0.00999148
1083,1,1083,2559495,256059356,0.00999571
1085,2,2170,2561665,256059356,0.0100042
1086,1,1086,2562751,256059356,0.0100084
1087,6,6522,2569273,256059356,0.0100339
1088,1,1088,2570361,256059356,0.0100381
1090,2,2180,2572541,256059356,0.0100467
1092,1,1092,2573633,256059356,0.0100509
1094,1,1094,2574727,256059356,0.0100552
1097,1,1097,2575824,256059356,0.0100595
1098,3,3294,2579118,256059356,0.0100723
1101,1,1101,2580219,256059356,0.0100766
1102,1,1102,2581321,256059356,0.0100809
1103,5,5515,2586836,256059356,0.0101025
1104,1,1104,2587940,256059356,0.0101068
1105,1,1105,2589045,256059356,0.0101111
1106,4,4424,2593469,256059356,0.0101284
1108,5,5540,2599009,256059356,0.01015
1109,1,1109,2600118,256059356,0.0101544
1111,1,1111,2601229,256059356,0.0101587
1112,4,4448,2605677,256059356,0.0101761
1113,1,1113,2606790,256059356,0.0101804
1114,5,5570,2612360,256059356,0.0102022
1115,4,4460,2616820,256059356,0.0102196
1116,2,2232,2619052,256059356,0.0102283
1118,1,1118,2620170,256059356,0.0102327
1119,2,2238,2622408,256059356,0.0102414
1120,1,1120,2623528,256059356,0.0102458
1122,5,5610,2629138,256059356,0.0102677
1123,3,3369,2632507,256059356,0.0102808
1124,2,2248,2634755,256059356,0.0102896
1126,1,1126,2635881,256059356,0.010294
1127,3,3381,2639262,256059356,0.0103072
1129,1,1129,2640391,256059356,0.0103116
1130,3,3390,2643781,256059356,0.0103249
1131,1,1131,2644912,256059356,0.0103293
1132,1,1132,2646044,256059356,0.0103337
1133,1,1133,2647177,256059356,0.0103381
1135,1,1135,2648312,256059356,0.0103426
1139,1,1139,2649451,256059356,0.010347
1140,2,2280,2651731,256059356,0.0103559
1141,2,2282,2654013,256059356,0.0103648
1142,2,2284,2656297,256059356,0.0103738
1143,1,1143,2657440,256059356,0.0103782
1145,1,1145,2658585,256059356,0.0103827
1146,3,3438,2662023,256059356,0.0103961
1148,2,2296,2664319,256059356,0.0104051
1149,2,2298,2666617,256059356,0.0104141
1150,3,3450,2670067,256059356,0.0104275
1153,2,2306,2672373,256059356,0.0104365
1155,4,4620,2676993,256059356,0.0104546
1156,1,1156,2678149,256059356,0.0104591
1157,2,2314,2680463,256059356,0.0104681
1158,3,3474,2683937,256059356,0.0104817
1159,3,3477,2687414,256059356,0.0104953
1160,1,1160,2688574,256059356,0.0104998
1161,1,1161,2689735,256059356,0.0105043
1165,1,1165,2690900,256059356,0.0105089
1167,3,3501,2694401,256059356,0.0105226
1168,3,3504,2697905,256059356,0.0105362
1169,1,1169,2699074,256059356,0.0105408
1171,3,3513,2702587,256059356,0.0105545
1172,4,4688,2707275,256059356,0.0105728
1173,2,2346,2709621,256059356,0.010582
1175,3,3525,2713146,256059356,0.0105958
1178,1,1178,2714324,256059356,0.0106004
1179,2,2358,2716682,256059356,0.0106096
1180,1,1180,2717862,256059356,0.0106142
1181,1,1181,2719043,256059356,0.0106188
1182,3,3546,2722589,256059356,0.0106326
1183,2,2366,2724955,256059356,0.0106419
1184,3,3552,2728507,256059356,0.0106558
1188,3,3564,2732071,256059356,0.0106697
1190,3,3570,2735641,256059356,0.0106836
1191,1,1191,2736832,256059356,0.0106883
1193,1,1193,2738025,256059356,0.0106929
1194,3,3582,2741607,256059356,0.0107069
1195,5,5975,2747582,256059356,0.0107303
1202,2,2404,2749986,256059356,0.0107396
1205,1,1205,2751191,256059356,0.0107443
1206,1,1206,2752397,256059356,0.0107491
1208,1,1208,2753605,256059356,0.0107538
1211,1,1211,2754816,256059356,0.0107585
1212,1,1212,2756028,256059356,0.0107632
1214,2,2428,2758456,256059356,0.0107727
1215,1,1215,2759671,256059356,0.0107775
1217,5,6085,2765756,256059356,0.0108012
1219,1,1219,2766975,256059356,0.010806
1222,2,2444,2769419,256059356,0.0108155
1224,1,1224,2770643,256059356,0.0108203
1225,1,1225,2771868,256059356,0.0108251
1226,5,6130,2777998,256059356,0.010849
1227,1,1227,2779225,256059356,0.0108538
1228,5,6140,2785365,256059356,0.0108778
1230,2,2460,2787825,256059356,0.0108874
1231,2,2462,2790287,256059356,0.010897
1235,2,2470,2792757,256059356,0.0109067
1236,1,1236,2793993,256059356,0.0109115
1238,2,2476,2796469,256059356,0.0109212
1239,2,2478,2798947,256059356,0.0109309
1240,4,4960,2803907,256059356,0.0109502
1241,2,2482,2806389,256059356,0.0109599
1249,5,6245,2812634,256059356,0.0109843
1250,5,6250,2818884,256059356,0.0110087
1251,2,2502,2821386,256059356,0.0110185
1254,2,2508,2823894,256059356,0.0110283
1255,1,1255,2825149,256059356,0.0110332
1256,1,1256,2826405,256059356,0.0110381
1257,1,1257,2827662,256059356,0.011043
1259,1,1259,2828921,256059356,0.0110479
1260,2,2520,2831441,256059356,0.0110578
1262,1,1262,2832703,256059356,0.0110627
1264,4,5056,2837759,256059356,0.0110824
1266,1,1266,2839025,256059356,0.0110874
1269,3,3807,2842832,256059356,0.0111022
1271,1,1271,2844103,256059356,0.0111072
1274,1,1274,2845377,256059356,0.0111122
1275,1,1275,2846652,256059356,0.0111172
1277,3,3831,2850483,256059356,0.0111321
1279,1,1279,2851762,256059356,0.0111371
1280,1,1280,2853042,256059356,0.0111421
1282,1,1282,2854324,256059356,0.0111471
1284,1,1284,2855608,256059356,0.0111521
1286,1,1286,2856894,256059356,0.0111572
1288,1,1288,2858182,256059356,0.0111622
1289,1,1289,2859471,256059356,0.0111672
1293,1,1293,2860764,256059356,0.0111723
1296,1,1296,2862060,256059356,0.0111773
1297,1,1297,2863357,256059356,0.0111824
1299,2,2598,2865955,256059356,0.0111925
1300,1,1300,2867255,256059356,0.0111976
1301,3,3903,2871158,256059356,0.0112129
1302,2,2604,2873762,256059356,0.011223
1303,2,2606,2876368,256059356,0.0112332
1304,1,1304,2877672,256059356,0.0112383
1308,2,2616,2880288,256059356,0.0112485
1310,2,2620,2882908,256059356,0.0112587
1312,2,2624,2885532,256059356,0.011269
1315,1,1315,2886847,256059356,0.0112741
1316,2,2632,2889479,256059356,0.0112844
1317,1,1317,2890796,256059356,0.0112896
1318,1,1318,2892114,256059356,0.0112947
1319,2,2638,2894752,256059356,0.011305
1321,2,2642,2897394,256059356,0.0113153
1322,2,2644,2900038,256059356,0.0113256
1324,1,1324,2901362,256059356,0.0113308
1325,3,3975,2905337,256059356,0.0113463
1327,1,1327,2906664,256059356,0.0113515
1328,7,9296,2915960,256059356,0.0113878
1329,1,1329,2917289,256059356,0.011393
1331,12,15972,2933261,256059356,0.0114554
1332,1,1332,2934593,256059356,0.0114606
1334,1,1334,2935927,256059356,0.0114658
1335,3,4005,2939932,256059356,0.0114814
1337,1,1337,2941269,256059356,0.0114867
1338,4,5352,2946621,256059356,0.0115076
1341,1,1341,2947962,256059356,0.0115128
1344,2,2688,2950650,256059356,0.0115233
1345,3,4035,2954685,256059356,0.0115391
1346,1,1346,2956031,256059356,0.0115443
1349,1,1349,2957380,256059356,0.0115496
1350,1,1350,2958730,256059356,0.0115549
1351,2,2702,2961432,256059356,0.0115654
1352,1,1352,2962784,256059356,0.0115707
1355,2,2710,2965494,256059356,0.0115813
1356,1,1356,2966850,256059356,0.0115866
1358,1,1358,2968208,256059356,0.0115919
1360,3,4080,2972288,256059356,0.0116078
1361,2,2722,2975010,256059356,0.0116184
1364,1,1364,2976374,256059356,0.0116238
1369,1,1369,2977743,256059356,0.0116291
1370,1,1370,2979113,256059356,0.0116345
1372,2,2744,2981857,256059356,0.0116452
1373,1,1373,2983230,256059356,0.0116505
1374,1,1374,2984604,256059356,0.0116559
1376,2,2752,2987356,256059356,0.0116667
1379,3,4137,2991493,256059356,0.0116828
1385,1,1385,2992878,256059356,0.0116882
1386,4,5544,2998422,256059356,0.0117099
1387,2,2774,3001196,256059356,0.0117207
1389,1,1389,3002585,256059356,0.0117261
1391,3,4173,3006758,256059356,0.0117424
1393,2,2786,3009544,256059356,0.0117533
1394,2,2788,3012332,256059356,0.0117642
1397,2,2794,3015126,256059356,0.0117751
1400,1,1400,3016526,256059356,0.0117806
1405,1,1405,3017931,256059356,0.0117861
1407,2,2814,3020745,256059356,0.011797
1409,1,1409,3022154,256059356,0.0118026
1413,3,4239,3026393,256059356,0.0118191
1415,1,1415,3027808,256059356,0.0118246
1419,1,1419,3029227,256059356,0.0118302
1420,3,4260,3033487,256059356,0.0118468
1421,1,1421,3034908,256059356,0.0118524
1422,1,1422,3036330,256059356,0.0118579
1424,1,1424,3037754,256059356,0.0118635
1425,2,2850,3040604,256059356,0.0118746
1427,2,2854,3043458,256059356,0.0118858
1428,1,1428,3044886,256059356,0.0118913
1429,5,7145,3052031,256059356,0.0119192
1430,1,1430,3053461,256059356,0.0119248
1431,1,1431,3054892,256059356,0.0119304
1433,1,1433,3056325,256059356,0.011936
1435,1,1435,3057760,256059356,0.0119416
1436,2,2872,3060632,256059356,0.0119528
1437,1,1437,3062069,256059356,0.0119584
1439,1,1439,3063508,256059356,0.0119641
1440,1,1440,3064948,256059356,0.0119697
1441,2,2882,3067830,256059356,0.0119809
1442,1,1442,3069272,256059356,0.0119866
1443,2,2886,3072158,256059356,0.0119978
1444,3,4332,3076490,256059356,0.0120148
1451,2,2902,3079392,256059356,0.0120261
1452,1,1452,3080844,256059356,0.0120318
1453,1,1453,3082297,256059356,0.0120374
1454,3,4362,3086659,256059356,0.0120545
1455,1,1455,3088114,256059356,0.0120601
1461,4,5844,3093958,256059356,0.012083
1462,1,1462,3095420,256059356,0.0120887
1463,3,4389,3099809,256059356,0.0121058
1464,1,1464,3101273,256059356,0.0121115
1469,3,4407,3105680,256059356,0.0121288
1471,3,4413,3110093,256059356,0.012146
1472,1,1472,3111565,256059356,0.0121517
1475,1,1475,3113040,256059356,0.0121575
1476,1,1476,3114516,256059356,0.0121633
1478,2,2956,3117472,256059356,0.0121748
1483,2,2966,3120438,256059356,0.0121864
1484,1,1484,3121922,256059356,0.0121922
1485,1,1485,3123407,256059356,0.012198
1487,1,1487,3124894,256059356,0.0122038
1490,1,1490,3126384,256059356,0.0122096
1492,2,2984,3129368,256059356,0.0122213
1493,1,1493,3130861,256059356,0.0122271
1496,2,2992,3133853,256059356,0.0122388
1499,1,1499,3135352,256059356,0.0122446
1502,1,1502,3136854,256059356,0.0122505
1506,1,1506,3138360,256059356,0.0122564
1511,1,1511,3139871,256059356,0.0122623
1512,1,1512,3141383,256059356,0.0122682
1513,1,1513,3142896,256059356,0.0122741
1514,1,1514,3144410,256059356,0.01228
1516,2,3032,3147442,256059356,0.0122918
1517,3,4551,3151993,256059356,0.0123096
1519,1,1519,3153512,256059356,0.0123156
1522,1,1522,3155034,256059356,0.0123215
1527,4,6108,3161142,256059356,0.0123453
1528,2,3056,3164198,256059356,0.0123573
1531,1,1531,3165729,256059356,0.0123633
1532,3,4596,3170325,256059356,0.0123812
1533,3,4599,3174924,256059356,0.0123992
1534,1,1534,3176458,256059356,0.0124052
1537,2,3074,3179532,256059356,0.0124172
1538,1,1538,3181070,256059356,0.0124232
1541,1,1541,3182611,256059356,0.0124292
1542,1,1542,3184153,256059356,0.0124352
1547,1,1547,3185700,256059356,0.0124413
1548,1,1548,3187248,256059356,0.0124473
1550,2,3100,3190348,256059356,0.0124594
1552,1,1552,3191900,256059356,0.0124655
1555,2,3110,3195010,256059356,0.0124776
1556,2,3112,3198122,256059356,0.0124898
1557,1,1557,3199679,256059356,0.0124958
1558,1,1558,3201237,256059356,0.0125019
1560,2,3120,3204357,256059356,0.0125141
1562,1,1562,3205919,256059356,0.0125202
1563,4,6252,3212171,256059356,0.0125446
1568,1,1568,3213739,256059356,0.0125508
1569,1,1569,3215308,256059356,0.0125569
1573,4,6292,3221600,256059356,0.0125815
1574,1,1574,3223174,256059356,0.0125876
1576,1,1576,3224750,256059356,0.0125938
1579,1,1579,3226329,256059356,0.0125999
1580,2,3160,3229489,256059356,0.0126123
1583,3,4749,3234238,256059356,0.0126308
1584,1,1584,3235822,256059356,0.012637
1585,1,1585,3237407,256059356,0.0126432
1588,1,1588,3238995,256059356,0.0126494
1589,2,3178,3242173,256059356,0.0126618
1590,1,1590,3243763,256059356,0.012668
1591,3,4773,3248536,256059356,0.0126867
1593,1,1593,3250129,256059356,0.0126929
1597,1,1597,3251726,256059356,0.0126991
1600,1,1600,3253326,256059356,0.0127054
1605,1,1605,3254931,256059356,0.0127116
1606,1,1606,3256537,256059356,0.0127179
1612,1,1612,3258149,256059356,0.0127242
1614,2,3228,3261377,256059356,0.0127368
1616,3,4848,3266225,256059356,0.0127557
1618,3,4854,3271079,256059356,0.0127747
1619,2,3238,3274317,256059356,0.0127873
1621,3,4863,3279180,256059356,0.0128063
1622,2,3244,3282424,256059356,0.012819
1624,1,1624,3284048,256059356,0.0128253
1626,1,1626,3285674,256059356,0.0128317
1628,1,1628,3287302,256059356,0.012838
1629,2,3258,3290560,256059356,0.0128508
1631,2,3262,3293822,256059356,0.0128635
1633,1,1633,3295455,256059356,0.0128699
1637,1,1637,3297092,256059356,0.0128763
1638,2,3276,3300368,256059356,0.0128891
1642,2,3284,3303652,256059356,0.0129019
1643,2,3286,3306938,256059356,0.0129147
1652,1,1652,3308590,256059356,0.0129212
1655,1,1655,3310245,256059356,0.0129276
1656,1,1656,3311901,256059356,0.0129341
1658,2,3316,3315217,256059356,0.0129471
1659,1,1659,3316876,256059356,0.0129535
1665,1,1665,3318541,256059356,0.01296
1668,2,3336,3321877,256059356,0.0129731
1671,5,8355,3330232,256059356,0.0130057
1673,1,1673,3331905,256059356,0.0130122
1675,3,5025,3336930,256059356,0.0130319
1680,2,3360,3340290,256059356,0.013045
1682,4,6728,3347018,256059356,0.0130713
1683,1,1683,3348701,256059356,0.0130778
1685,2,3370,3352071,256059356,0.013091
1686,1,1686,3353757,256059356,0.0130976
1690,6,10140,3363897,256059356,0.0131372
1691,2,3382,3367279,256059356,0.0131504
1693,2,3386,3370665,256059356,0.0131636
1699,1,1699,3372364,256059356,0.0131702
1702,1,1702,3374066,256059356,0.0131769
1705,1,1705,3375771,256059356,0.0131835
1706,1,1706,3377477,256059356,0.0131902
1713,1,1713,3379190,256059356,0.0131969
1716,2,3432,3382622,256059356,0.0132103
1717,1,1717,3384339,256059356,0.013217
1718,1,1718,3386057,256059356,0.0132237
1723,1,1723,3387780,256059356,0.0132304
1724,1,1724,3389504,256059356,0.0132372
1730,1,1730,3391234,256059356,0.0132439
1731,2,3462,3394696,256059356,0.0132575
1736,1,1736,3396432,256059356,0.0132642
1738,1,1738,3398170,256059356,0.013271
1739,1,1739,3399909,256059356,0.0132778
1740,2,3480,3403389,256059356,0.0132914
1748,2,3496,3406885,256059356,0.0133051
1753,1,1753,3408638,256059356,0.0133119
1755,2,3510,3412148,256059356,0.0133256
1756,5,8780,3420928,256059356,0.0133599
1757,2,3514,3424442,256059356,0.0133736
1762,1,1762,3426204,256059356,0.0133805
1767,1,1767,3427971,256059356,0.0133874
1771,3,5313,3433284,256059356,0.0134082
1772,5,8860,3442144,256059356,0.0134428
1776,1,1776,3443920,256059356,0.0134497
1783,2,3566,3447486,256059356,0.0134636
1788,1,1788,3449274,256059356,0.0134706
1789,1,1789,3451063,256059356,0.0134776
1792,2,3584,3454647,256059356,0.0134916
1793,2,3586,3458233,256059356,0.0135056
1802,3,5406,3463639,256059356,0.0135267
1803,1,1803,3465442,256059356,0.0135337
1807,2,3614,3469056,256059356,0.0135479
1808,1,1808,3470864,256059356,0.0135549
1813,3,5439,3476303,256059356,0.0135762
1815,2,3630,3479933,256059356,0.0135903
1817,1,1817,3481750,256059356,0.0135974
1819,2,3638,3485388,256059356,0.0136116
1821,3,5463,3490851,256059356,0.013633
1822,3,5466,3496317,256059356,0.0136543
1824,1,1824,3498141,256059356,0.0136614
1827,2,3654,3501795,256059356,0.0136757
1830,2,3660,3505455,256059356,0.01369
1832,2,3664,3509119,256059356,0.0137043
1834,1,1834,3510953,256059356,0.0137115
1835,1,1835,3512788,256059356,0.0137186
1836,2,3672,3516460,256059356,0.013733
1844,1,1844,3518304,256059356,0.0137402
1846,3,5538,3523842,256059356,0.0137618
1849,1,1849,3525691,256059356,0.013769
1852,3,5556,3531247,256059356,0.0137907
1856,1,1856,3533103,256059356,0.013798
1858,4,7432,3540535,256059356,0.013827
1859,1,1859,3542394,256059356,0.0138343
1861,4,7444,3549838,256059356,0.0138633
1862,1,1862,3551700,256059356,0.0138706
1868,2,3736,3555436,256059356,0.0138852
1869,1,1869,3557305,256059356,0.0138925
1870,2,3740,3561045,256059356,0.0139071
1871,5,9355,3570400,256059356,0.0139436
1872,1,1872,3572272,256059356,0.013951
1876,1,1876,3574148,256059356,0.0139583
1887,1,1887,3576035,256059356,0.0139656
1898,1,1898,3577933,256059356,0.0139731
1900,4,7600,3585533,256059356,0.0140027
1901,2,3802,3589335,256059356,0.0140176
1905,1,1905,3591240,256059356,0.014025
1906,3,5718,3596958,256059356,0.0140474
1907,2,3814,3600772,256059356,0.0140623
1909,1,1909,3602681,256059356,0.0140697
1914,1,1914,3604595,256059356,0.0140772
1918,1,1918,3606513,256059356,0.0140847
1922,2,3844,3610357,256059356,0.0140997
1926,3,5778,3616135,256059356,0.0141223
1929,1,1929,3618064,256059356,0.0141298
1932,3,5796,3623860,256059356,0.0141524
1935,2,3870,3627730,256059356,0.0141675
1937,1,1937,3629667,256059356,0.0141751
1947,1,1947,3631614,256059356,0.0141827
1949,2,3898,3635512,256059356,0.0141979
1950,1,1950,3637462,256059356,0.0142055
1951,1,1951,3639413,256059356,0.0142132
1952,1,1952,3641365,256059356,0.0142208
1954,2,3908,3645273,256059356,0.014236
1959,1,1959,3647232,256059356,0.0142437
1960,1,1960,3649192,256059356,0.0142514
1979,1,1979,3651171,256059356,0.0142591
1982,2,3964,3655135,256059356,0.0142746
1983,1,1983,3657118,256059356,0.0142823
1986,2,3972,3661090,256059356,0.0142978
1988,1,1988,3663078,256059356,0.0143056
1994,1,1994,3665072,256059356,0.0143134
1995,1,1995,3667067,256059356,0.0143212
1996,1,1996,3669063,256059356,0.014329
2000,6,12000,3681063,256059356,0.0143758
2004,1,2004,3683067,256059356,0.0143836
2005,1,2005,3685072,256059356,0.0143915
2008,2,4016,3689088,256059356,0.0144072
2011,1,2011,3691099,256059356,0.014415
2016,1,2016,3693115,256059356,0.0144229
2017,1,2017,3695132,256059356,0.0144308
2018,1,2018,3697150,256059356,0.0144386
2019,1,2019,3699169,256059356,0.0144465
2022,2,4044,3703213,256059356,0.0144623
2023,1,2023,3705236,256059356,0.0144702
2025,2,4050,3709286,256059356,0.014486
2027,1,2027,3711313,256059356,0.014494
2031,1,2031,3713344,256059356,0.0145019
2034,1,2034,3715378,256059356,0.0145098
2036,1,2036,3717414,256059356,0.0145178
2038,1,2038,3719452,256059356,0.0145257
2043,1,2043,3721495,256059356,0.0145337
2050,1,2050,3723545,256059356,0.0145417
2053,2,4106,3727651,256059356,0.0145578
2054,1,2054,3729705,256059356,0.0145658
2060,2,4120,3733825,256059356,0.0145819
2062,1,2062,3735887,256059356,0.0145899
2063,1,2063,3737950,256059356,0.014598
2064,1,2064,3740014,256059356,0.014606
2065,1,2065,3742079,256059356,0.0146141
2067,2,4134,3746213,256059356,0.0146303
2068,1,2068,3748281,256059356,0.0146383
2069,1,2069,3750350,256059356,0.0146464
2075,1,2075,3752425,256059356,0.0146545
2077,1,2077,3754502,256059356,0.0146626
2081,2,4162,3758664,256059356,0.0146789
2094,3,6282,3764946,256059356,0.0147034
2100,2,4200,3769146,256059356,0.0147198
2107,2,4214,3773360,256059356,0.0147363
2108,2,4216,3777576,256059356,0.0147527
2109,1,2109,3779685,256059356,0.014761
2120,1,2120,3781805,256059356,0.0147693
2123,3,6369,3788174,256059356,0.0147941
2125,1,2125,3790299,256059356,0.0148024
2126,2,4252,3794551,256059356,0.014819
2128,1,2128,3796679,256059356,0.0148273
2129,1,2129,3798808,256059356,0.0148357
2130,1,2130,3800938,256059356,0.014844
2133,1,2133,3803071,256059356,0.0148523
2137,1,2137,3805208,256059356,0.0148606
2141,1,2141,3807349,256059356,0.014869
2145,2,4290,3811639,256059356,0.0148858
2155,1,2155,3813794,256059356,0.0148942
2159,1,2159,3815953,256059356,0.0149026
2171,1,2171,3818124,256059356,0.0149111
2174,1,2174,3820298,256059356,0.0149196
2176,1,2176,3822474,256059356,0.0149281
2178,1,2178,3824652,256059356,0.0149366
2179,1,2179,3826831,256059356,0.0149451
2187,2,4374,3831205,256059356,0.0149622
2188,1,2188,3833393,256059356,0.0149707
2189,3,6567,3839960,256059356,0.0149964
2190,1,2190,3842150,256059356,0.0150049
2193,1,2193,3844343,256059356,0.0150135
2194,2,4388,3848731,256059356,0.0150306
2195,1,2195,3850926,256059356,0.0150392
2206,1,2206,3853132,256059356,0.0150478
2212,2,4424,3857556,256059356,0.0150651
2215,1,2215,3859771,256059356,0.0150737
2217,4,8868,3868639,256059356,0.0151084
2221,1,2221,3870860,256059356,0.015117
2230,1,2230,3873090,256059356,0.0151258
2231,1,2231,3875321,256059356,0.0151345
2236,3,6708,3882029,256059356,0.0151607
2240,1,2240,3884269,256059356,0.0151694
2241,1,2241,3886510,256059356,0.0151782
2244,1,2244,3888754,256059356,0.0151869
2249,2,4498,3893252,256059356,0.0152045
2259,1,2259,3895511,256059356,0.0152133
2268,2,4536,3900047,256059356,0.015231
2270,1,2270,3902317,256059356,0.0152399
2273,3,6819,3909136,256059356,0.0152665
2276,2,4552,3913688,256059356,0.0152843
2279,2,4558,3918246,256059356,0.0153021
2287,1,2287,3920533,256059356,0.015311
2288,2,4576,3925109,256059356,0.0153289
2289,2,4578,3929687,256059356,0.0153468
2290,2,4580,3934267,256059356,0.0153647
2294,1,2294,3936561,256059356,0.0153736
2307,1,2307,3938868,256059356,0.0153826
2310,3,6930,3945798,256059356,0.0154097
2311,3,6933,3952731,256059356,0.0154368
2324,1,2324,3955055,256059356,0.0154459
2327,3,6981,3962036,256059356,0.0154731
2329,1,2329,3964365,256059356,0.0154822
2330,1,2330,3966695,256059356,0.0154913
2333,1,2333,3969028,256059356,0.0155004
2335,1,2335,3971363,256059356,0.0155095
2340,1,2340,3973703,256059356,0.0155187
2343,1,2343,3976046,256059356,0.0155278
2350,1,2350,3978396,256059356,0.015537
2354,2,4708,3983104,256059356,0.0155554
2359,1,2359,3985463,256059356,0.0155646
2361,2,4722,3990185,256059356,0.015583
2362,2,4724,3994909,256059356,0.0156015
2363,1,2363,3997272,256059356,0.0156107
2365,1,2365,3999637,256059356,0.01562
2367,1,2367,4002004,256059356,0.0156292
2368,1,2368,4004372,256059356,0.0156385
2373,1,2373,4006745,256059356,0.0156477
2376,1,2376,4009121,256059356,0.015657
2378,1,2378,4011499,256059356,0.0156663
2380,1,2380,4013879,256059356,0.0156756
2386,1,2386,4016265,256059356,0.0156849
2390,1,2390,4018655,256059356,0.0156942
2397,4,9588,4028243,256059356,0.0157317
2398,1,2398,4030641,256059356,0.015741
2402,1,2402,4033043,256059356,0.0157504
2418,1,2418,4035461,256059356,0.0157599
2421,1,2421,4037882,256059356,0.0157693
2424,1,2424,4040306,256059356,0.0157788
2431,1,2431,4042737,256059356,0.0157883
2432,1,2432,4045169,256059356,0.0157978
2437,1,2437,4047606,256059356,0.0158073
2438,2,4876,4052482,256059356,0.0158263
2444,1,2444,4054926,256059356,0.0158359
2446,2,4892,4059818,256059356,0.015855
2453,1,2453,4062271,256059356,0.0158646
2458,1,2458,4064729,256059356,0.0158742
2459,3,7377,4072106,256059356,0.015903
2463,1,2463,4074569,256059356,0.0159126
2465,1,2465,4077034,256059356,0.0159222
2469,1,2469,4079503,256059356,0.0159319
2472,1,2472,4081975,256059356,0.0159415
2476,1,2476,4084451,256059356,0.0159512
2477,2,4954,4089405,256059356,0.0159705
2480,1,2480,4091885,256059356,0.0159802
2483,1,2483,4094368,256059356,0.0159899
2493,1,2493,4096861,256059356,0.0159997
2500,1,2500,4099361,256059356,0.0160094
2501,2,5002,4104363,256059356,0.016029
2505,1,2505,4106868,256059356,0.0160387
2506,2,5012,4111880,256059356,0.0160583
2508,1,2508,4114388,256059356,0.0160681
2511,1,2511,4116899,256059356,0.0160779
2520,2,5040,4121939,256059356,0.0160976
2524,1,2524,4124463,256059356,0.0161074
2535,1,2535,4126998,256059356,0.0161173
2536,3,7608,4134606,256059356,0.0161471
2545,1,2545,4137151,256059356,0.016157
2547,1,2547,4139698,256059356,0.0161669
2548,2,5096,4144794,256059356,0.0161868
2549,1,2549,4147343,256059356,0.0161968
2557,3,7671,4155014,256059356,0.0162268
2567,2,5134,4160148,256059356,0.0162468
2569,1,2569,4162717,256059356,0.0162568
2572,1,2572,4165289,256059356,0.0162669
2578,2,5156,4170445,256059356,0.016287
2580,2,5160,4175605,256059356,0.0163072
2584,3,7752,4183357,256059356,0.0163375
2589,1,2589,4185946,256059356,0.0163476
2591,1,2591,4188537,256059356,0.0163577
2594,1,2594,4191131,256059356,0.0163678
2595,1,2595,4193726,256059356,0.0163779
2598,1,2598,4196324,256059356,0.0163881
2600,1,2600,4198924,256059356,0.0163982
2605,6,15630,4214554,256059356,0.0164593
2624,1,2624,4217178,256059356,0.0164695
2630,1,2630,4219808,256059356,0.0164798
2634,2,5268,4225076,256059356,0.0165004
2636,1,2636,4227712,256059356,0.0165107
2642,1,2642,4230354,256059356,0.016521
2651,1,2651,4233005,256059356,0.0165313
2655,3,7965,4240970,256059356,0.0165624
2656,3,7968,4248938,256059356,0.0165936
2675,2,5350,4254288,256059356,0.0166145
2679,1,2679,4256967,256059356,0.0166249
2680,1,2680,4259647,256059356,0.0166354
2684,1,2684,4262331,256059356,0.0166459
2688,1,2688,4265019,256059356,0.0166564
2694,1,2694,4267713,256059356,0.0166669
2698,1,2698,4270411,256059356,0.0166774
2699,3,8097,4278508,256059356,0.016709
2701,1,2701,4281209,256059356,0.0167196
2711,1,2711,4283920,256059356,0.0167302
2717,1,2717,4286637,256059356,0.0167408
2719,1,2719,4289356,256059356,0.0167514
2729,1,2729,4292085,256059356,0.0167621
2734,1,2734,4294819,256059356,0.0167727
2739,1,2739,4297558,256059356,0.0167834
2744,2,5488,4303046,256059356,0.0168049
2745,1,2745,4305791,256059356,0.0168156
2746,1,2746,4308537,256059356,0.0168263
2752,2,5504,4314041,256059356,0.0168478
2756,2,5512,4319553,256059356,0.0168693
2772,1,2772,4322325,256059356,0.0168802
2775,2,5550,4327875,256059356,0.0169018
2783,1,2783,4330658,256059356,0.0169127
2784,1,2784,4333442,256059356,0.0169236
2785,1,2785,4336227,256059356,0.0169345
2787,1,2787,4339014,256059356,0.0169453
2793,1,2793,4341807,256059356,0.0169563
2802,1,2802,4344609,256059356,0.0169672
2804,1,2804,4347413,256059356,0.0169781
2807,2,5614,4353027,256059356,0.0170001
2808,1,2808,4355835,256059356,0.017011
2810,1,2810,4358645,256059356,0.017022
2811,1,2811,4361456,256059356,0.017033
2813,1,2813,4364269,256059356,0.017044
2819,1,2819,4367088,256059356,0.017055
2825,1,2825,4369913,256059356,0.017066
2827,2,5654,4375567,256059356,0.0170881
2828,1,2828,4378395,256059356,0.0170991
2835,1,2835,4381230,256059356,0.0171102
2859,2,5718,4386948,256059356,0.0171325
2864,1,2864,4389812,256059356,0.0171437
2867,1,2867,4392679,256059356,0.0171549
2868,2,5736,4398415,256059356,0.0171773
2877,3,8631,4407046,256059356,0.017211
2879,2,5758,4412804,256059356,0.0172335
2880,1,2880,4415684,256059356,0.0172448
2887,1,2887,4418571,256059356,0.017256
2890,1,2890,4421461,256059356,0.0172673
2894,1,2894,4424355,256059356,0.0172786
2897,1,2897,4427252,256059356,0.0172899
2898,1,2898,4430150,256059356,0.0173013
2907,1,2907,4433057,256059356,0.0173126
2909,2,5818,4438875,256059356,0.0173353
2914,1,2914,4441789,256059356,0.0173467
2918,1,2918,4444707,256059356,0.0173581
2928,1,2928,4447635,256059356,0.0173695
2929,1,2929,4450564,256059356,0.017381
2944,1,2944,4453508,256059356,0.0173925
2946,6,17676,4471184,256059356,0.0174615
2958,1,2958,4474142,256059356,0.0174731
2962,1,2962,4477104,256059356,0.0174846
2967,1,2967,4480071,256059356,0.0174962
2969,1,2969,4483040,256059356,0.0175078
2971,1,2971,4486011,256059356,0.0175194
2972,2,5944,4491955,256059356,0.0175426
2974,1,2974,4494929,256059356,0.0175542
2978,1,2978,4497907,256059356,0.0175659
2980,3,8940,4506847,256059356,0.0176008
2982,2,5964,4512811,256059356,0.0176241
2987,1,2987,4515798,256059356,0.0176357
2995,1,2995,4518793,256059356,0.0176474
2996,1,2996,4521789,256059356,0.0176591
2997,1,2997,4524786,256059356,0.0176708
3000,1,3000,4527786,256059356,0.0176826
3004,1,3004,4530790,256059356,0.0176943
3012,1,3012,4533802,256059356,0.0177061
3013,1,3013,4536815,256059356,0.0177178
3022,3,9066,4545881,256059356,0.0177532
3023,3,9069,4554950,256059356,0.0177886
3028,1,3028,4557978,256059356,0.0178005
3031,1,3031,4561009,256059356,0.0178123
3035,1,3035,4564044,256059356,0.0178242
3037,1,3037,4567081,256059356,0.017836
3038,2,6076,4573157,256059356,0.0178598
3040,1,3040,4576197,256059356,0.0178716
3043,1,3043,4579240,256059356,0.0178835
3049,2,6098,4585338,256059356,0.0179073
3051,1,3051,4588389,256059356,0.0179192
3053,5,15265,4603654,256059356,0.0179789
3063,1,3063,4606717,256059356,0.0179908
3066,1,3066,4609783,256059356,0.0180028
3070,4,12280,4622063,256059356,0.0180507
3072,1,3072,4625135,256059356,0.0180627
3074,1,3074,4628209,256059356,0.0180748
3079,1,3079,4631288,256059356,0.0180868
3080,1,3080,4634368,256059356,0.0180988
3083,1,3083,4637451,256059356,0.0181108
3086,1,3086,4640537,256059356,0.0181229
3089,1,3089,4643626,256059356,0.018135
3090,1,3090,4646716,256059356,0.018147
3099,1,3099,4649815,256059356,0.0181591
3101,1,3101,4652916,256059356,0.0181712
3105,2,6210,4659126,256059356,0.0181955
3106,1,3106,4662232,256059356,0.0182076
3113,1,3113,4665345,256059356,0.0182198
3116,1,3116,4668461,256059356,0.0182319
3119,1,3119,4671580,256059356,0.0182441
3121,3,9363,4680943,256059356,0.0182807
3123,1,3123,4684066,256059356,0.0182929
3125,1,3125,4687191,256059356,0.0183051
3131,2,6262,4693453,256059356,0.0183296
3133,1,3133,4696586,256059356,0.0183418
3134,1,3134,4699720,256059356,0.018354
3135,3,9405,4709125,256059356,0.0183908
3136,2,6272,4715397,256059356,0.0184152
3138,6,18828,4734225,256059356,0.0184888
3143,1,3143,4737368,256059356,0.0185011
3146,3,9438,4746806,256059356,0.0185379
3148,2,6296,4753102,256059356,0.0185625
3149,2,6298,4759400,256059356,0.0185871
3152,1,3152,4762552,256059356,0.0185994
3156,1,3156,4765708,256059356,0.0186117
3160,2,6320,4772028,256059356,0.0186364
3161,1,3161,4775189,256059356,0.0186488
3165,2,6330,4781519,256059356,0.0186735
3168,1,3168,4784687,256059356,0.0186859
3169,1,3169,4787856,256059356,0.0186982
3170,1,3170,4791026,256059356,0.0187106
3171,4,12684,4803710,256059356,0.0187601
3178,1,3178,4806888,256059356,0.0187726
3179,4,12716,4819604,256059356,0.0188222
3181,3,9543,4829147,256059356,0.0188595
3182,3,9546,4838693,256059356,0.0188968
3183,1,3183,4841876,256059356,0.0189092
3185,1,3185,4845061,256059356,0.0189216
3186,3,9558,4854619,256059356,0.018959
3189,1,3189,4857808,256059356,0.0189714
3190,4,12760,4870568,256059356,0.0190212
3193,2,6386,4876954,256059356,0.0190462
3194,1,3194,4880148,256059356,0.0190587
3195,1,3195,4883343,256059356,0.0190711
3199,2,6398,4889741,256059356,0.0190961
3206,1,3206,4892947,256059356,0.0191086
3208,2,6416,4899363,256059356,0.0191337
3211,1,3211,4902574,256059356,0.0191462
3216,1,3216,4905790,256059356,0.0191588
3221,3,9663,4915453,256059356,0.0191965
3222,2,6444,4921897,256059356,0.0192217
3223,2,6446,4928343,256059356,0.0192469
3225,1,3225,4931568,256059356,0.0192595
3243,1,3243,4934811,256059356,0.0192721
3245,1,3245,4938056,256059356,0.0192848
3259,2,6518,4944574,256059356,0.0193103
3260,1,3260,4947834,256059356,0.019323
3266,1,3266,4951100,256059356,0.0193358
3274,1,3274,4954374,256059356,0.0193485
3276,2,6552,4960926,256059356,0.0193741
3287,2,6574,4967500,256059356,0.0193998
3289,1,3289,4970789,256059356,0.0194126
3293,1,3293,4974082,256059356,0.0194255
3312,1,3312,4977394,256059356,0.0194384
3319,1,3319,4980713,256059356,0.0194514
3321,1,3321,4984034,256059356,0.0194644
3325,1,3325,4987359,256059356,0.0194774
3326,1,3326,4990685,256059356,0.0194903
3340,1,3340,4994025,256059356,0.0195034
3342,1,3342,4997367,256059356,0.0195164
3354,1,3354,5000721,256059356,0.0195295
3368,1,3368,5004089,256059356,0.0195427
3377,1,3377,5007466,256059356,0.0195559
3379,2,6758,5014224,256059356,0.0195823
3382,2,6764,5020988,256059356,0.0196087
3385,1,3385,5024373,256059356,0.0196219
3390,1,3390,5027763,256059356,0.0196351
3396,1,3396,5031159,256059356,0.0196484
3403,2,6806,5037965,256059356,0.019675
3405,1,3405,5041370,256059356,0.0196883
3406,1,3406,5044776,256059356,0.0197016
3414,1,3414,5048190,256059356,0.0197149
3416,1,3416,5051606,256059356,0.0197283
3418,1,3418,5055024,256059356,0.0197416
3423,1,3423,5058447,256059356,0.019755
3425,1,3425,5061872,256059356,0.0197684
3431,2,6862,5068734,256059356,0.0197952
3432,1,3432,5072166,256059356,0.0198086
3434,2,6868,5079034,256059356,0.0198354
3436,1,3436,5082470,256059356,0.0198488
3440,1,3440,5085910,256059356,0.0198622
3441,1,3441,5089351,256059356,0.0198757
3446,1,3446,5092797,256059356,0.0198891
3447,1,3447,5096244,256059356,0.0199026
3449,1,3449,5099693,256059356,0.0199161
3452,1,3452,5103145,256059356,0.0199295
3456,2,6912,5110057,256059356,0.0199565
3460,1,3460,5113517,256059356,0.01997
3468,1,3468,5116985,256059356,0.0199836
3481,1,3481,5120466,256059356,0.0199972
3485,1,3485,5123951,256059356,0.0200108
3493,1,3493,5127444,256059356,0.0200244
3494,1,3494,5130938,256059356,0.0200381
3498,1,3498,5134436,256059356,0.0200517
3534,3,10602,5145038,256059356,0.0200931
3543,2,7086,5152124,256059356,0.0201208
3544,1,3544,5155668,256059356,0.0201347
3545,3,10635,5166303,256059356,0.0201762
3546,4,14184,5180487,256059356,0.0202316
3547,1,3547,5184034,256059356,0.0202454
3552,2,7104,5191138,256059356,0.0202732
3561,1,3561,5194699,256059356,0.0202871
3569,1,3569,5198268,256059356,0.020301
3572,2,7144,5205412,256059356,0.0203289
3573,2,7146,5212558,256059356,0.0203568
3577,1,3577,5216135,256059356,0.0203708
3581,1,3581,5219716,256059356,0.0203848
3587,2,7174,5226890,256059356,0.0204128
3590,1,3590,5230480,256059356,0.0204268
3603,1,3603,5234083,256059356,0.0204409
3623,1,3623,5237706,256059356,0.020455
3624,1,3624,5241330,256059356,0.0204692
3626,1,3626,5244956,256059356,0.0204834
3631,1,3631,5248587,256059356,0.0204975
3635,1,3635,5252222,256059356,0.0205117
3642,1,3642,5255864,256059356,0.020526
3643,1,3643,5259507,256059356,0.0205402
3649,1,3649,5263156,256059356,0.0205544
3665,1,3665,5266821,256059356,0.0205688
3667,1,3667,5270488,256059356,0.0205831
3671,1,3671,5274159,256059356,0.0205974
3672,1,3672,5277831,256059356,0.0206117
3676,3,11028,5288859,256059356,0.0206548
3677,3,11031,5299890,256059356,0.0206979
3686,1,3686,5303576,256059356,0.0207123
3687,1,3687,5307263,256059356,0.0207267
3698,1,3698,5310961,256059356,0.0207411
3699,3,11097,5322058,256059356,0.0207845
3703,3,11109,5333167,256059356,0.0208279
3728,1,3728,5336895,256059356,0.0208424
3731,1,3731,5340626,256059356,0.020857
3732,1,3732,5344358,256059356,0.0208716
3757,1,3757,5348115,256059356,0.0208862
3764,2,7528,5355643,256059356,0.0209156
3765,1,3765,5359408,256059356,0.0209303
3766,1,3766,5363174,256059356,0.020945
3769,1,3769,5366943,256059356,0.0209598
3776,1,3776,5370719,256059356,0.0209745
3782,3,11346,5382065,256059356,0.0210188
3786,2,7572,5389637,256059356,0.0210484
3790,2,7580,5397217,256059356,0.021078
3793,1,3793,5401010,256059356,0.0210928
3809,1,3809,5404819,256059356,0.0211077
3811,1,3811,5408630,256059356,0.0211226
3812,1,3812,5412442,256059356,0.0211375
3818,5,19090,5431532,256059356,0.021212
3821,1,3821,5435353,256059356,0.0212269
3824,1,3824,5439177,256059356,0.0212419
3830,2,7660,5446837,256059356,0.0212718
3832,1,3832,5450669,256059356,0.0212867
3837,1,3837,5454506,256059356,0.0213017
3840,1,3840,5458346,256059356,0.0213167
3847,1,3847,5462193,256059356,0.0213317
3851,1,3851,5466044,256059356,0.0213468
3870,2,7740,5473784,256059356,0.021377
3872,1,3872,5477656,256059356,0.0213921
3877,1,3877,5481533,256059356,0.0214073
3880,1,3880,5485413,256059356,0.0214224
3881,1,3881,5489294,256059356,0.0214376
3897,1,3897,5493191,256059356,0.0214528
3903,1,3903,5497094,256059356,0.021468
3913,3,11739,5508833,256059356,0.0215139
3916,4,15664,5524497,256059356,0.0215751
3917,1,3917,5528414,256059356,0.0215904
3923,1,3923,5532337,256059356,0.0216057
3925,1,3925,5536262,256059356,0.021621
3927,1,3927,5540189,256059356,0.0216363
3930,1,3930,5544119,256059356,0.0216517
3937,3,11811,5555930,256059356,0.0216978
3948,1,3948,5559878,256059356,0.0217132
3963,1,3963,5563841,256059356,0.0217287
3969,1,3969,5567810,256059356,0.0217442
3972,1,3972,5571782,256059356,0.0217597
3976,1,3976,5575758,256059356,0.0217753
3979,3,11937,5587695,256059356,0.0218219
3981,2,7962,5595657,256059356,0.021853
3985,2,7970,5603627,256059356,0.0218841
3986,2,7972,5611599,256059356,0.0219152
3987,1,3987,5615586,256059356,0.0219308
3992,1,3992,5619578,256059356,0.0219464
4006,2,8012,5627590,256059356,0.0219777
4008,2,8016,5635606,256059356,0.022009
4023,1,4023,5639629,256059356,0.0220247
4024,1,4024,5643653,256059356,0.0220404
4026,1,4026,5647679,256059356,0.0220561
4032,1,4032,5651711,256059356,0.0220719
4039,1,4039,5655750,256059356,0.0220877
4046,1,4046,5659796,256059356,0.0221035
4051,1,4051,5663847,256059356,0.0221193
4058,1,4058,5667905,256059356,0.0221351
4061,2,8122,5676027,256059356,0.0221668
4065,1,4065,5680092,256059356,0.0221827
4067,1,4067,5684159,256059356,0.0221986
4078,1,4078,5688237,256059356,0.0222145
4085,3,12255,5700492,256059356,0.0222624
4088,2,8176,5708668,256059356,0.0222943
4091,1,4091,5712759,256059356,0.0223103
4103,1,4103,5716862,256059356,0.0223263
4121,1,4121,5720983,256059356,0.0223424
4126,1,4126,5725109,256059356,0.0223585
4127,3,12381,5737490,256059356,0.0224069
4131,1,4131,5741621,256059356,0.022423
4146,1,4146,5745767,256059356,0.0224392
4148,1,4148,5749915,256059356,0.0224554
4153,1,4153,5754068,256059356,0.0224716
4163,1,4163,5758231,256059356,0.0224879
4167,1,4167,5762398,256059356,0.0225041
4170,1,4170,5766568,256059356,0.0225204
4171,1,4171,5770739,256059356,0.0225367
4176,1,4176,5774915,256059356,0.022553
4178,1,4178,5779093,256059356,0.0225693
4192,2,8384,5787477,256059356,0.0226021
4193,1,4193,5791670,256059356,0.0226185
4194,1,4194,5795864,256059356,0.0226348
4205,1,4205,5800069,256059356,0.0226513
4231,1,4231,5804300,256059356,0.0226678
4237,1,4237,5808537,256059356,0.0226843
4250,1,4250,5812787,256059356,0.0227009
4253,1,4253,5817040,256059356,0.0227175
4256,1,4256,5821296,256059356,0.0227342
4258,1,4258,5825554,256059356,0.0227508
4259,1,4259,5829813,256059356,0.0227674
4262,1,4262,5834075,256059356,0.0227841
4278,3,12834,5846909,256059356,0.0228342
4284,1,4284,5851193,256059356,0.0228509
4298,1,4298,5855491,256059356,0.0228677
4299,1,4299,5859790,256059356,0.0228845
4301,2,8602,5868392,256059356,0.0229181
4305,2,8610,5877002,256059356,0.0229517
4307,1,4307,5881309,256059356,0.0229685
4310,2,8620,5889929,256059356,0.0230022
4317,1,4317,5894246,256059356,0.0230191
4318,1,4318,5898564,256059356,0.0230359
4325,1,4325,5902889,256059356,0.0230528
4326,1,4326,5907215,256059356,0.0230697
4332,1,4332,5911547,256059356,0.0230866
4335,1,4335,5915882,256059356,0.0231036
4345,1,4345,5920227,256059356,0.0231205
4350,1,4350,5924577,256059356,0.0231375
4353,1,4353,5928930,256059356,0.0231545
4354,1,4354,5933284,256059356,0.0231715
4364,1,4364,5937648,256059356,0.0231886
4371,1,4371,5942019,256059356,0.0232056
4372,1,4372,5946391,256059356,0.0232227
4381,1,4381,5950772,256059356,0.0232398
4389,1,4389,5955161,256059356,0.023257
4392,2,8784,5963945,256059356,0.0232913
4396,1,4396,5968341,256059356,0.0233084
4400,1,4400,5972741,256059356,0.0233256
4414,1,4414,5977155,256059356,0.0233428
4418,2,8836,5985991,256059356,0.0233774
4420,1,4420,5990411,256059356,0.0233946
4423,3,13269,6003680,256059356,0.0234464
4424,1,4424,6008104,256059356,0.0234637
4433,1,4433,6012537,256059356,0.023481
4436,1,4436,6016973,256059356,0.0234984
4442,1,4442,6021415,256059356,0.0235157
4446,2,8892,6030307,256059356,0.0235504
4447,2,8894,6039201,256059356,0.0235852
4451,1,4451,6043652,256059356,0.0236025
4452,1,4452,6048104,256059356,0.0236199
4476,1,4476,6052580,256059356,0.0236374
4477,3,13431,6066011,256059356,0.0236899
4488,1,4488,6070499,256059356,0.0237074
4506,3,13518,6084017,256059356,0.0237602
4508,1,4508,6088525,256059356,0.0237778
4527,1,4527,6093052,256059356,0.0237955
4532,1,4532,6097584,256059356,0.0238132
4537,1,4537,6102121,256059356,0.0238309
4543,1,4543,6106664,256059356,0.0238486
4546,1,4546,6111210,256059356,0.0238664
4549,1,4549,6115759,256059356,0.0238841
4551,1,4551,6120310,256059356,0.0239019
4553,1,4553,6124863,256059356,0.0239197
4569,1,4569,6129432,256059356,0.0239375
4574,1,4574,6134006,256059356,0.0239554
4578,1,4578,6138584,256059356,0.0239733
4587,1,4587,6143171,256059356,0.0239912
4590,1,4590,6147761,256059356,0.0240091
4592,1,4592,6152353,256059356,0.0240271
4600,2,9200,6161553,256059356,0.024063
4602,1,4602,6166155,256059356,0.024081
4606,1,4606,6170761,256059356,0.0240989
4607,1,4607,6175368,256059356,0.0241169
4620,1,4620,6179988,256059356,0.024135
4624,1,4624,6184612,256059356,0.024153
4629,1,4629,6189241,256059356,0.0241711
4643,1,4643,6193884,256059356,0.0241893
4652,1,4652,6198536,256059356,0.0242074
4657,1,4657,6203193,256059356,0.0242256
4659,2,9318,6212511,256059356,0.024262
4660,2,9320,6221831,256059356,0.0242984
4679,1,4679,6226510,256059356,0.0243167
4682,1,4682,6231192,256059356,0.024335
4690,1,4690,6235882,256059356,0.0243533
4697,4,18788,6254670,256059356,0.0244266
4701,10,47010,6301680,256059356,0.0246102
4706,1,4706,6306386,256059356,0.0246286
4714,1,4714,6311100,256059356,0.024647
4721,2,9442,6320542,256059356,0.0246839
4727,3,14181,6334723,256059356,0.0247393
4729,1,4729,6339452,256059356,0.0247577
4731,1,4731,6344183,256059356,0.0247762
4740,1,4740,6348923,256059356,0.0247947
4753,1,4753,6353676,256059356,0.0248133
4759,1,4759,6358435,256059356,0.0248319
4760,1,4760,6363195,256059356,0.0248505
4765,3,14295,6377490,256059356,0.0249063
4766,2,9532,6387022,256059356,0.0249435
4772,8,38176,6425198,256059356,0.0250926
4786,1,4786,6429984,256059356,0.0251113
4788,2,9576,6439560,256059356,0.0251487
4796,1,4796,6444356,256059356,0.0251674
4813,1,4813,6449169,256059356,0.0251862
4816,1,4816,6453985,256059356,0.025205
4819,2,9638,6463623,256059356,0.0252427
4827,1,4827,6468450,256059356,0.0252615
4832,1,4832,6473282,256059356,0.0252804
4839,2,9678,6482960,256059356,0.0253182
4847,1,4847,6487807,256059356,0.0253371
4851,1,4851,6492658,256059356,0.0253561
4873,2,9746,6502404,256059356,0.0253941
4874,1,4874,6507278,256059356,0.0254132
4877,1,4877,6512155,256059356,0.0254322
4881,1,4881,6517036,256059356,0.0254513
4882,2,9764,6526800,256059356,0.0254894
4891,3,14673,6541473,256059356,0.0255467
4910,1,4910,6546383,256059356,0.0255659
4911,1,4911,6551294,256059356,0.0255851
4912,2,9824,6561118,256059356,0.0256234
4913,1,4913,6566031,256059356,0.0256426
4918,1,4918,6570949,256059356,0.0256618
4930,1,4930,6575879,256059356,0.0256811
4932,1,4932,6580811,256059356,0.0257003
4933,1,4933,6585744,256059356,0.0257196
4939,2,9878,6595622,256059356,0.0257582
4943,1,4943,6600565,256059356,0.0257775
4946,1,4946,6605511,256059356,0.0257968
4991,1,4991,6610502,256059356,0.0258163
5004,1,5004,6615506,256059356,0.0258358
5018,1,5018,6620524,256059356,0.0258554
5026,1,5026,6625550,256059356,0.0258751
5038,1,5038,6630588,256059356,0.0258947
5051,1,5051,6635639,256059356,0.0259145
5064,2,10128,6645767,256059356,0.025954
5080,1,5080,6650847,256059356,0.0259738
5101,1,5101,6655948,256059356,0.0259938
5103,1,5103,6661051,256059356,0.0260137
5106,3,15318,6676369,256059356,0.0260735
5122,1,5122,6681491,256059356,0.0260935
5146,1,5146,6686637,256059356,0.0261136
5149,1,5149,6691786,256059356,0.0261337
5158,1,5158,6696944,256059356,0.0261539
5167,1,5167,6702111,256059356,0.0261741
5170,1,5170,6707281,256059356,0.0261942
5171,2,10342,6717623,256059356,0.0262346
5176,1,5176,6722799,256059356,0.0262548
5183,1,5183,6727982,256059356,0.0262751
5187,1,5187,6733169,256059356,0.0262953
5234,1,5234,6738403,256059356,0.0263158
5254,1,5254,6743657,256059356,0.0263363
5258,1,5258,6748915,256059356,0.0263568
5266,1,5266,6754181,256059356,0.0263774
5270,1,5270,6759451,256059356,0.026398
5275,1,5275,6764726,256059356,0.0264186
5281,1,5281,6770007,256059356,0.0264392
5299,1,5299,6775306,256059356,0.0264599
5320,1,5320,6780626,256059356,0.0264807
5333,1,5333,6785959,256059356,0.0265015
5343,1,5343,6791302,256059356,0.0265224
5359,1,5359,6796661,256059356,0.0265433
5360,1,5360,6802021,256059356,0.0265642
5372,1,5372,6807393,256059356,0.0265852
5380,1,5380,6812773,256059356,0.0266062
5386,1,5386,6818159,256059356,0.0266273
5393,1,5393,6823552,256059356,0.0266483
5410,1,5410,6828962,256059356,0.0266694
5447,1,5447,6834409,256059356,0.0266907
5453,1,5453,6839862,256059356,0.026712
5458,1,5458,6845320,256059356,0.0267333
5465,1,5465,6850785,256059356,0.0267547
5473,1,5473,6856258,256059356,0.026776
5523,3,16569,6872827,256059356,0.0268408
5531,1,5531,6878358,256059356,0.0268624
5533,1,5533,6883891,256059356,0.026884
5537,1,5537,6889428,256059356,0.0269056
5543,1,5543,6894971,256059356,0.0269272
5562,1,5562,6900533,256059356,0.026949
5582,1,5582,6906115,256059356,0.0269708
5587,1,5587,6911702,256059356,0.0269926
5607,1,5607,6917309,256059356,0.0270145
5609,1,5609,6922918,256059356,0.0270364
5617,1,5617,6928535,256059356,0.0270583
5638,1,5638,6934173,256059356,0.0270803
5659,3,16977,6951150,256059356,0.0271466
5666,1,5666,6956816,256059356,0.0271688
5684,1,5684,6962500,256059356,0.027191
5685,1,5685,6968185,256059356,0.0272132
5689,1,5689,6973874,256059356,0.0272354
5718,1,5718,6979592,256059356,0.0272577
5750,1,5750,6985342,256059356,0.0272802
5784,1,5784,6991126,256059356,0.0273028
5788,1,5788,6996914,256059356,0.0273254
5791,1,5791,7002705,256059356,0.027348
5799,1,5799,7008504,256059356,0.0273706
5801,1,5801,7014305,256059356,0.0273933
5819,1,5819,7020124,256059356,0.027416
5822,2,11644,7031768,256059356,0.0274615
5832,1,5832,7037600,256059356,0.0274843
5837,1,5837,7043437,256059356,0.027507
5838,1,5838,7049275,256059356,0.0275298
5854,1,5854,7055129,256059356,0.0275527
5857,1,5857,7060986,256059356,0.0275756
5865,1,5865,7066851,256059356,0.0275985
5869,1,5869,7072720,256059356,0.0276214
5892,1,5892,7078612,256059356,0.0276444
5894,2,11788,7090400,256059356,0.0276905
5927,1,5927,7096327,256059356,0.0277136
5929,1,5929,7102256,256059356,0.0277368
5947,1,5947,7108203,256059356,0.02776
5980,2,11960,7120163,256059356,0.0278067
5986,1,5986,7126149,256059356,0.0278301
5989,1,5989,7132138,256059356,0.0278535
5990,1,5990,7138128,256059356,0.0278768
5999,1,5999,7144127,256059356,0.0279003
6064,1,6064,7150191,256059356,0.027924
6104,3,18312,7168503,256059356,0.0279955
6105,1,6105,7174608,256059356,0.0280193
6109,1,6109,7180717,256059356,0.0280432
6122,1,6122,7186839,256059356,0.0280671
6126,1,6126,7192965,256059356,0.028091
6133,1,6133,7199098,256059356,0.028115
6150,1,6150,7205248,256059356,0.028139
6152,1,6152,7211400,256059356,0.028163
6162,1,6162,7217562,256059356,0.0281871
6163,1,6163,7223725,256059356,0.0282111
6167,1,6167,7229892,256059356,0.0282352
6169,1,6169,7236061,256059356,0.0282593
6183,1,6183,7242244,256059356,0.0282835
6188,1,6188,7248432,256059356,0.0283076
6200,1,6200,7254632,256059356,0.0283318
6201,1,6201,7260833,256059356,0.0283561
6204,2,12408,7273241,256059356,0.0284045
6205,3,18615,7291856,256059356,0.0284772
6207,3,18621,7310477,256059356,0.0285499
6217,1,6217,7316694,256059356,0.0285742
6218,3,18654,7335348,256059356,0.0286471
6219,2,12438,7347786,256059356,0.0286956
6221,1,6221,7354007,256059356,0.0287199
6244,1,6244,7360251,256059356,0.0287443
6245,1,6245,7366496,256059356,0.0287687
6247,1,6247,7372743,256059356,0.0287931
6248,2,12496,7385239,256059356,0.0288419
6250,2,12500,7397739,256059356,0.0288907
6255,1,6255,7403994,256059356,0.0289151
6268,1,6268,7410262,256059356,0.0289396
6270,1,6270,7416532,256059356,0.0289641
6275,1,6275,7422807,256059356,0.0289886
6279,1,6279,7429086,256059356,0.0290131
6297,1,6297,7435383,256059356,0.0290377
6322,3,18966,7454349,256059356,0.0291118
6323,1,6323,7460672,256059356,0.0291365
6341,1,6341,7467013,256059356,0.0291613
6365,1,6365,7473378,256059356,0.0291861
6400,1,6400,7479778,256059356,0.0292111
6411,2,12822,7492600,256059356,0.0292612
6439,1,6439,7499039,256059356,0.0292863
6446,1,6446,7505485,256059356,0.0293115
6457,1,6457,7511942,256059356,0.0293367
6460,1,6460,7518402,256059356,0.0293619
6475,1,6475,7524877,256059356,0.0293872
6488,1,6488,7531365,256059356,0.0294126
6543,1,6543,7537908,256059356,0.0294381
6559,1,6559,7544467,256059356,0.0294637
6564,1,6564,7551031,256059356,0.0294894
6567,1,6567,7557598,256059356,0.029515
6589,3,19767,7577365,256059356,0.0295922
6593,1,6593,7583958,256059356,0.029618
6611,1,6611,7590569,256059356,0.0296438
6620,3,19860,7610429,256059356,0.0297213
6633,1,6633,7617062,256059356,0.0297473
6634,3,19902,7636964,256059356,0.029825
6687,1,6687,7643651,256059356,0.0298511
6697,1,6697,7650348,256059356,0.0298772
6717,1,6717,7657065,256059356,0.0299035
6733,1,6733,7663798,256059356,0.0299298
6758,1,6758,7670556,256059356,0.0299562
6778,2,13556,7684112,256059356,0.0300091
6785,3,20355,7704467,256059356,0.0300886
6787,2,13574,7718041,256059356,0.0301416
6788,2,13576,7731617,256059356,0.0301946
6797,1,6797,7738414,256059356,0.0302212
6824,1,6824,7745238,256059356,0.0302478
6832,1,6832,7752070,256059356,0.0302745
6834,1,6834,7758904,256059356,0.0303012
6867,1,6867,7765771,256059356,0.030328
6869,1,6869,7772640,256059356,0.0303548
6876,1,6876,7779516,256059356,0.0303817
6882,2,13764,7793280,256059356,0.0304354
6887,1,6887,7800167,256059356,0.0304623
6929,1,6929,7807096,256059356,0.0304894
6943,1,6943,7814039,256059356,0.0305165
6952,1,6952,7820991,256059356,0.0305437
6966,1,6966,7827957,256059356,0.0305709
7005,1,7005,7834962,256059356,0.0305982
7012,1,7012,7841974,256059356,0.0306256
7025,1,7025,7848999,256059356,0.030653
7026,1,7026,7856025,256059356,0.0306805
7035,1,7035,7863060,256059356,0.030708
7066,1,7066,7870126,256059356,0.0307356
7067,2,14134,7884260,256059356,0.0307908
7070,1,7070,7891330,256059356,0.0308184
7086,1,7086,7898416,256059356,0.030846
7102,1,7102,7905518,256059356,0.0308738
7123,1,7123,7912641,256059356,0.0309016
7130,1,7130,7919771,256059356,0.0309294
7139,1,7139,7926910,256059356,0.0309573
7161,2,14322,7941232,256059356,0.0310132
7166,1,7166,7948398,256059356,0.0310412
7182,6,43092,7991490,256059356,0.0312095
7212,1,7212,7998702,256059356,0.0312377
7219,1,7219,8005921,256059356,0.0312659
7234,1,7234,8013155,256059356,0.0312941
7256,1,7256,8020411,256059356,0.0313225
7288,1,7288,8027699,256059356,0.0313509
7308,4,29232,8056931,256059356,0.0314651
7312,1,7312,8064243,256059356,0.0314936
7318,1,7318,8071561,256059356,0.0315222
7350,1,7350,8078911,256059356,0.0315509
7403,1,7403,8086314,256059356,0.0315798
7404,1,7404,8093718,256059356,0.0316088
7440,1,7440,8101158,256059356,0.0316378
7445,1,7445,8108603,256059356,0.0316669
7474,1,7474,8116077,256059356,0.0316961
7490,1,7490,8123567,256059356,0.0317253
7509,1,7509,8131076,256059356,0.0317547
7524,1,7524,8138600,256059356,0.031784
7539,1,7539,8146139,256059356,0.0318135
7556,1,7556,8153695,256059356,0.031843
7559,1,7559,8161254,256059356,0.0318725
7563,1,7563,8168817,256059356,0.031902
7565,1,7565,8176382,256059356,0.0319316
7575,1,7575,8183957,256059356,0.0319612
7594,1,7594,8191551,256059356,0.0319908
7610,1,7610,8199161,256059356,0.0320205
7640,2,15280,8214441,256059356,0.0320802
7655,1,7655,8222096,256059356,0.0321101
7665,2,15330,8237426,256059356,0.03217
7697,1,7697,8245123,256059356,0.0322
7766,1,7766,8252889,256059356,0.0322304
7767,2,15534,8268423,256059356,0.032291
7770,1,7770,8276193,256059356,0.0323214
7823,1,7823,8284016,256059356,0.0323519
7836,1,7836,8291852,256059356,0.0323825
7837,1,7837,8299689,256059356,0.0324131
7846,1,7846,8307535,256059356,0.0324438
7851,1,7851,8315386,256059356,0.0324744
7861,1,7861,8323247,256059356,0.0325051
7864,1,7864,8331111,256059356,0.0325359
7878,1,7878,8338989,256059356,0.0325666
7887,2,15774,8354763,256059356,0.0326282
7888,1,7888,8362651,256059356,0.032659
7889,1,7889,8370540,256059356,0.0326898
7891,1,7891,8378431,256059356,0.0327207
7907,1,7907,8386338,256059356,0.0327515
7922,1,7922,8394260,256059356,0.0327825
7924,1,7924,8402184,256059356,0.0328134
7925,1,7925,8410109,256059356,0.0328444
7936,1,7936,8418045,256059356,0.0328754
7942,3,23826,8441871,256059356,0.0329684
7948,1,7948,8449819,256059356,0.0329995
8010,1,8010,8457829,256059356,0.0330307
8011,1,8011,8465840,256059356,0.033062
8014,2,16028,8481868,256059356,0.0331246
8015,1,8015,8489883,256059356,0.0331559
8019,2,16038,8505921,256059356,0.0332186
8033,1,8033,8513954,256059356,0.0332499
8047,1,8047,8522001,256059356,0.0332813
8062,1,8062,8530063,256059356,0.0333128
8081,1,8081,8538144,256059356,0.0333444
8085,1,8085,8546229,256059356,0.033376
8090,1,8090,8554319,256059356,0.0334076
8091,1,8091,8562410,256059356,0.0334392
8105,1,8105,8570515,256059356,0.0334708
8117,2,16234,8586749,256059356,0.0335342
8118,1,8118,8594867,256059356,0.0335659
8173,1,8173,8603040,256059356,0.0335978
8191,1,8191,8611231,256059356,0.0336298
8201,1,8201,8619432,256059356,0.0336619
8223,1,8223,8627655,256059356,0.033694
8227,1,8227,8635882,256059356,0.0337261
8249,2,16498,8652380,256059356,0.0337905
8269,1,8269,8660649,256059356,0.0338228
8281,1,8281,8668930,256059356,0.0338552
8286,1,8286,8677216,256059356,0.0338875
8336,1,8336,8685552,256059356,0.0339201
8390,1,8390,8693942,256059356,0.0339528
8391,1,8391,8702333,256059356,0.0339856
8410,2,16820,8719153,256059356,0.0340513
8429,1,8429,8727582,256059356,0.0340842
8444,1,8444,8736026,256059356,0.0341172
8458,1,8458,8744484,256059356,0.0341502
8478,1,8478,8752962,256059356,0.0341833
8515,1,8515,8761477,256059356,0.0342166
8518,1,8518,8769995,256059356,0.0342499
8550,3,25650,8795645,256059356,0.03435
8554,2,17108,8812753,256059356,0.0344168
8561,2,17122,8829875,256059356,0.0344837
8563,1,8563,8838438,256059356,0.0345171
8564,1,8564,8847002,256059356,0.0345506
8581,1,8581,8855583,256059356,0.0345841
8609,1,8609,8864192,256059356,0.0346177
8613,2,17226,8881418,256059356,0.034685
8614,1,8614,8890032,256059356,0.0347186
8619,1,8619,8898651,256059356,0.0347523
8621,1,8621,8907272,256059356,0.034786
8622,1,8622,8915894,256059356,0.0348196
8624,1,8624,8924518,256059356,0.0348533
8636,1,8636,8933154,256059356,0.034887
8637,1,8637,8941791,256059356,0.0349208
8638,1,8638,8950429,256059356,0.0349545
8680,1,8680,8959109,256059356,0.0349884
8682,1,8682,8967791,256059356,0.0350223
8693,1,8693,8976484,256059356,0.0350563
8751,2,17502,8993986,256059356,0.0351246
8766,1,8766,9002752,256059356,0.0351588
8789,1,8789,9011541,256059356,0.0351932
8812,1,8812,9020353,256059356,0.0352276
8821,1,8821,9029174,256059356,0.035262
8825,1,8825,9037999,256059356,0.0352965
8830,1,8830,9046829,256059356,0.035331
8848,1,8848,9055677,256059356,0.0353655
8850,1,8850,9064527,256059356,0.0354001
8857,1,8857,9073384,256059356,0.0354347
8858,1,8858,9082242,256059356,0.0354693
8866,1,8866,9091108,256059356,0.0355039
8881,1,8881,9099989,256059356,0.0355386
8889,1,8889,9108878,256059356,0.0355733
8935,1,8935,9117813,256059356,0.0356082
8950,1,8950,9126763,256059356,0.0356432
8998,1,8998,9135761,256059356,0.0356783
9009,1,9009,9144770,256059356,0.0357135
9084,3,27252,9172022,256059356,0.0358199
9103,1,9103,9181125,256059356,0.0358555
9108,1,9108,9190233,256059356,0.035891
9149,1,9149,9199382,256059356,0.0359268
9154,1,9154,9208536,256059356,0.0359625
9159,1,9159,9217695,256059356,0.0359983
9164,2,18328,9236023,256059356,0.0360699
9203,1,9203,9245226,256059356,0.0361058
9229,1,9229,9254455,256059356,0.0361418
9230,1,9230,9263685,256059356,0.0361779
9293,1,9293,9272978,256059356,0.0362142
9299,1,9299,9282277,256059356,0.0362505
9303,2,18606,9300883,256059356,0.0363232
9306,1,9306,9310189,256059356,0.0363595
9315,1,9315,9319504,256059356,0.0363959
9340,1,9340,9328844,256059356,0.0364323
9346,3,28038,9356882,256059356,0.0365418
9400,1,9400,9366282,256059356,0.0365786
9410,1,9410,9375692,256059356,0.0366153
9449,3,28347,9404039,256059356,0.036726
9452,2,18904,9422943,256059356,0.0367998
9484,1,9484,9432427,256059356,0.0368369
9522,1,9522,9441949,256059356,0.0368741
9536,1,9536,9451485,256059356,0.0369113
9549,2,19098,9470583,256059356,0.0369859
9550,1,9550,9480133,256059356,0.0370232
9551,1,9551,9489684,256059356,0.0370605
9565,1,9565,9499249,256059356,0.0370978
9583,1,9583,9508832,256059356,0.0371353
9589,2,19178,9528010,256059356,0.0372102
9597,1,9597,9537607,256059356,0.0372476
9607,1,9607,9547214,256059356,0.0372852
9618,1,9618,9556832,256059356,0.0373227
9625,1,9625,9566457,256059356,0.0373603
9636,1,9636,9576093,256059356,0.0373979
9678,1,9678,9585771,256059356,0.0374357
9732,1,9732,9595503,256059356,0.0374737
9778,1,9778,9605281,256059356,0.0375119
9849,1,9849,9615130,256059356,0.0375504
9867,1,9867,9624997,256059356,0.0375889
9869,1,9869,9634866,256059356,0.0376275
9889,1,9889,9644755,256059356,0.0376661
9919,1,9919,9654674,256059356,0.0377048
9950,1,9950,9664624,256059356,0.0377437
9988,2,19976,9684600,256059356,0.0378217
9998,1,9998,9694598,256059356,0.0378607
9999,1,9999,9704597,256059356,0.0378998
10010,1,10010,9714607,256059356,0.0379389
10019,2,20038,9734645,256059356,0.0380171
10075,1,10075,9744720,256059356,0.0380565
10096,2,20192,9764912,256059356,0.0381353
10122,1,10122,9775034,256059356,0.0381749
10129,1,10129,9785163,256059356,0.0382144
10137,1,10137,9795300,256059356,0.038254
10172,1,10172,9805472,256059356,0.0382937
10192,1,10192,9815664,256059356,0.0383335
10195,1,10195,9825859,256059356,0.0383734
10213,1,10213,9836072,256059356,0.0384132
10216,2,20432,9856504,256059356,0.038493
10231,2,20462,9876966,256059356,0.038573
10235,1,10235,9887201,256059356,0.0386129
10236,1,10236,9897437,256059356,0.0386529
10242,1,10242,9907679,256059356,0.0386929
10267,1,10267,9917946,256059356,0.038733
10273,1,10273,9928219,256059356,0.0387731
10275,1,10275,9938494,256059356,0.0388132
10305,1,10305,9948799,256059356,0.0388535
10314,1,10314,9959113,256059356,0.0388938
10330,1,10330,9969443,256059356,0.0389341
10345,1,10345,9979788,256059356,0.0389745
10415,1,10415,9990203,256059356,0.0390152
10453,1,10453,10000656,256059356,0.039056
10456,1,10456,10011112,256059356,0.0390968
10535,1,10535,10021647,256059356,0.039138
10559,1,10559,10032206,256059356,0.0391792
10586,1,10586,10042792,256059356,0.0392206
10613,1,10613,10053405,256059356,0.039262
10637,1,10637,10064042,256059356,0.0393036
10686,1,10686,10074728,256059356,0.0393453
10687,1,10687,10085415,256059356,0.039387
10727,1,10727,10096142,256059356,0.0394289
10731,1,10731,10106873,256059356,0.0394708
10737,1,10737,10117610,256059356,0.0395128
10758,1,10758,10128368,256059356,0.0395548
10909,1,10909,10139277,256059356,0.0395974
11003,1,11003,10150280,256059356,0.0396403
11033,1,11033,10161313,256059356,0.0396834
11134,2,22268,10183581,256059356,0.0397704
11210,1,11210,10194791,256059356,0.0398142
11217,1,11217,10206008,256059356,0.039858
11256,1,11256,10217264,256059356,0.0399019
11282,1,11282,10228546,256059356,0.039946
11291,1,11291,10239837,256059356,0.0399901
11353,1,11353,10251190,256059356,0.0400344
11376,2,22752,10273942,256059356,0.0401233
11404,1,11404,10285346,256059356,0.0401678
11436,1,11436,10296782,256059356,0.0402125
11495,1,11495,10308277,256059356,0.0402574
11501,1,11501,10319778,256059356,0.0403023
11517,1,11517,10331295,256059356,0.0403473
11520,3,34560,10365855,256059356,0.0404822
11521,2,23042,10388897,256059356,0.0405722
11611,1,11611,10400508,256059356,0.0406176
11663,1,11663,10412171,256059356,0.0406631
11682,1,11682,10423853,256059356,0.0407087
11713,1,11713,10435566,256059356,0.0407545
11714,1,11714,10447280,256059356,0.0408002
11725,1,11725,10459005,256059356,0.040846
11819,1,11819,10470824,256059356,0.0408922
11880,1,11880,10482704,256059356,0.0409386
11895,3,35685,10518389,256059356,0.0410779
11911,1,11911,10530300,256059356,0.0411244
12012,5,60060,10590360,256059356,0.041359
12023,1,12023,10602383,256059356,0.041406
12045,1,12045,10614428,256059356,0.041453
12131,1,12131,10626559,256059356,0.0415004
12132,1,12132,10638691,256059356,0.0415478
12148,2,24296,10662987,256059356,0.0416426
12161,1,12161,10675148,256059356,0.0416901
12175,1,12175,10687323,256059356,0.0417377
12201,1,12201,10699524,256059356,0.0417853
12232,1,12232,10711756,256059356,0.0418331
12239,1,12239,10723995,256059356,0.0418809
12267,1,12267,10736262,256059356,0.0419288
12308,2,24616,10760878,256059356,0.0420249
12311,1,12311,10773189,256059356,0.042073
12314,3,36942,10810131,256059356,0.0422173
12348,1,12348,10822479,256059356,0.0422655
12417,1,12417,10834896,256059356,0.042314
12423,1,12423,10847319,256059356,0.0423625
12438,1,12438,10859757,256059356,0.0424111
12446,2,24892,10884649,256059356,0.0425083
12581,1,12581,10897230,256059356,0.0425574
12626,1,12626,10909856,256059356,0.0426067
12731,1,12731,10922587,256059356,0.0426565
12736,1,12736,10935323,256059356,0.0427062
12760,1,12760,10948083,256059356,0.042756
12802,1,12802,10960885,256059356,0.042806
12805,1,12805,10973690,256059356,0.042856
12870,2,25740,10999430,256059356,0.0429566
12874,2,25748,11025178,256059356,0.0430571
12875,1,12875,11038053,256059356,0.0431074
12950,1,12950,11051003,256059356,0.043158
12970,1,12970,11063973,256059356,0.0432086
13002,1,13002,11076975,256059356,0.0432594
13016,1,13016,11089991,256059356,0.0433102
13017,1,13017,11103008,256059356,0.0433611
13041,1,13041,11116049,256059356,0.043412
13094,1,13094,11129143,256059356,0.0434631
13110,2,26220,11155363,256059356,0.0435655
13115,1,13115,11168478,256059356,0.0436168
13143,1,13143,11181621,256059356,0.0436681
13150,1,13150,11194771,256059356,0.0437194
13200,3,39600,11234371,256059356,0.0438741
13202,1,13202,11247573,256059356,0.0439256
13222,1,13222,11260795,256059356,0.0439773
13273,1,13273,11274068,256059356,0.0440291
13295,1,13295,11287363,256059356,0.044081
13310,1,13310,11300673,256059356,0.044133
13330,1,13330,11314003,256059356,0.0441851
13351,1,13351,11327354,256059356,0.0442372
13412,1,13412,11340766,256059356,0.0442896
13418,1,13418,11354184,256059356,0.044342
13529,1,13529,11367713,256059356,0.0443948
13532,2,27064,11394777,256059356,0.0445005
13535,1,13535,11408312,256059356,0.0445534
13605,1,13605,11421917,256059356,0.0446065
13638,2,27276,11449193,256059356,0.044713
13677,1,13677,11462870,256059356,0.0447665
13705,1,13705,11476575,256059356,0.04482
13751,1,13751,11490326,256059356,0.0448737
13791,1,13791,11504117,256059356,0.0449275
13857,1,13857,11517974,256059356,0.0449817
13870,2,27740,11545714,256059356,0.04509
13873,1,13873,11559587,256059356,0.0451442
13877,1,13877,11573464,256059356,0.0451984
13918,1,13918,11587382,256059356,0.0452527
13924,2,27848,11615230,256059356,0.0453615
13930,1,13930,11629160,256059356,0.0454159
13977,1,13977,11643137,256059356,0.0454705
13997,1,13997,11657134,256059356,0.0455251
14008,1,14008,11671142,256059356,0.0455798
14049,1,14049,11685191,256059356,0.0456347
14067,1,14067,11699258,256059356,0.0456896
14074,1,14074,11713332,256059356,0.0457446
14199,1,14199,11727531,256059356,0.0458
14201,1,14201,11741732,256059356,0.0458555
14226,1,14226,11755958,256059356,0.0459111
14271,2,28542,11784500,256059356,0.0460225
14275,1,14275,11798775,256059356,0.0460783
14287,1,14287,11813062,256059356,0.0461341
14300,2,28600,11841662,256059356,0.0462458
14331,1,14331,11855993,256059356,0.0463017
14350,1,14350,11870343,256059356,0.0463578
14352,1,14352,11884695,256059356,0.0464138
14355,2,28710,11913405,256059356,0.046526
14365,1,14365,11927770,256059356,0.0465821
14375,1,14375,11942145,256059356,0.0466382
14408,1,14408,11956553,256059356,0.0466945
14683,1,14683,11971236,256059356,0.0467518
14743,1,14743,11985979,256059356,0.0468094
14824,1,14824,12000803,256059356,0.0468673
14844,1,14844,12015647,256059356,0.0469252
14868,1,14868,12030515,256059356,0.0469833
14893,1,14893,12045408,256059356,0.0470415
14895,1,14895,12060303,256059356,0.0470996
14916,1,14916,12075219,256059356,0.0471579
14921,2,29842,12105061,256059356,0.0472744
14936,1,14936,12119997,256059356,0.0473328
14946,1,14946,12134943,256059356,0.0473911
15027,1,15027,12149970,256059356,0.0474498
15053,1,15053,12165023,256059356,0.0475086
15062,1,15062,12180085,256059356,0.0475674
15063,1,15063,12195148,256059356,0.0476263
15064,1,15064,12210212,256059356,0.0476851
15162,1,15162,12225374,256059356,0.0477443
15170,1,15170,12240544,256059356,0.0478035
15275,1,15275,12255819,256059356,0.0478632
15290,1,15290,12271109,256059356,0.0479229
15319,1,15319,12286428,256059356,0.0479827
15323,1,15323,12301751,256059356,0.0480426
15335,1,15335,12317086,256059356,0.0481025
15391,1,15391,12332477,256059356,0.0481626
15403,1,15403,12347880,256059356,0.0482227
15404,2,30808,12378688,256059356,0.048343
15442,1,15442,12394130,256059356,0.0484033
15463,1,15463,12409593,256059356,0.0484637
15538,1,15538,12425131,256059356,0.0485244
15613,1,15613,12440744,256059356,0.0485854
15614,1,15614,12456358,256059356,0.0486464
15653,1,15653,12472011,256059356,0.0487075
15655,1,15655,12487666,256059356,0.0487686
15664,1,15664,12503330,256059356,0.0488298
15705,1,15705,12519035,256059356,0.0488911
15732,1,15732,12534767,256059356,0.0489526
15734,2,31468,12566235,256059356,0.0490755
15783,12,189396,12755631,256059356,0.0498151
15784,1,15784,12771415,256059356,0.0498768
15787,2,31574,12802989,256059356,0.0500001
15789,1,15789,12818778,256059356,0.0500617
15795,1,15795,12834573,256059356,0.0501234
15798,1,15798,12850371,256059356,0.0501851
15801,1,15801,12866172,256059356,0.0502468
15835,1,15835,12882007,256059356,0.0503087
15836,1,15836,12897843,256059356,0.0503705
15840,1,15840,12913683,256059356,0.0504324
15847,1,15847,12929530,256059356,0.0504943
15848,1,15848,12945378,256059356,0.0505562
15867,2,31734,12977112,256059356,0.0506801
15921,1,15921,12993033,256059356,0.0507423
15983,2,31966,13024999,256059356,0.0508671
16161,1,16161,13041160,256059356,0.0509302
16265,1,16265,13057425,256059356,0.0509937
16272,1,16272,13073697,256059356,0.0510573
16278,2,32556,13106253,256059356,0.0511844
16288,2,32576,13138829,256059356,0.0513117
16302,1,16302,13155131,256059356,0.0513753
16317,1,16317,13171448,256059356,0.051439
16339,1,16339,13187787,256059356,0.0515029
16403,1,16403,13204190,256059356,0.0515669
16458,1,16458,13220648,256059356,0.0516312
16528,1,16528,13237176,256059356,0.0516957
16542,1,16542,13253718,256059356,0.0517603
16544,1,16544,13270262,256059356,0.0518249
16564,1,16564,13286826,256059356,0.0518896
16606,1,16606,13303432,256059356,0.0519545
16649,1,16649,13320081,256059356,0.0520195
16716,1,16716,13336797,256059356,0.0520848
16895,1,16895,13353692,256059356,0.0521508
16900,1,16900,13370592,256059356,0.0522168
16901,2,33802,13404394,256059356,0.0523488
16931,1,16931,13421325,256059356,0.0524149
16935,1,16935,13438260,256059356,0.052481
17080,1,17080,13455340,256059356,0.0525477
17150,1,17150,13472490,256059356,0.0526147
17154,1,17154,13489644,256059356,0.0526817
17254,2,34508,13524152,256059356,0.0528165
17485,1,17485,13541637,256059356,0.0528848
17490,1,17490,13559127,256059356,0.0529531
17491,1,17491,13576618,256059356,0.0530214
17498,1,17498,13594116,256059356,0.0530897
17504,1,17504,13611620,256059356,0.0531581
17546,1,17546,13629166,256059356,0.0532266
17559,1,17559,13646725,256059356,0.0532952
17688,1,17688,13664413,256059356,0.0533642
17724,1,17724,13682137,256059356,0.0534335
17735,1,17735,13699872,256059356,0.0535027
17779,1,17779,13717651,256059356,0.0535722
17869,1,17869,13735520,256059356,0.0536419
17890,1,17890,13753410,256059356,0.0537118
17898,1,17898,13771308,256059356,0.0537817
17939,1,17939,13789247,256059356,0.0538518
17971,1,17971,13807218,256059356,0.0539219
17987,1,17987,13825205,256059356,0.0539922
17994,2,35988,13861193,256059356,0.0541327
18012,1,18012,13879205,256059356,0.0542031
18089,1,18089,13897294,256059356,0.0542737
18096,1,18096,13915390,256059356,0.0543444
18139,1,18139,13933529,256059356,0.0544152
18146,1,18146,13951675,256059356,0.0544861
18166,1,18166,13969841,256059356,0.054557
18290,1,18290,13988131,256059356,0.0546285
18300,1,18300,14006431,256059356,0.0546999
18307,2,36614,14043045,256059356,0.0548429
18347,1,18347,14061392,256059356,0.0549146
18361,1,18361,14079753,256059356,0.0549863
18400,1,18400,14098153,256059356,0.0550581
18421,1,18421,14116574,256059356,0.0551301
18425,1,18425,14134999,256059356,0.055202
18436,1,18436,14153435,256059356,0.055274
18586,1,18586,14172021,256059356,0.0553466
18659,1,18659,14190680,256059356,0.0554195
18682,2,37364,14228044,256059356,0.0555654
18812,1,18812,14246856,256059356,0.0556389
18826,1,18826,14265682,256059356,0.0557124
18904,1,18904,14284586,256059356,0.0557862
18939,1,18939,14303525,256059356,0.0558602
19016,2,38032,14341557,256059356,0.0560087
19022,1,19022,14360579,256059356,0.056083
19026,1,19026,14379605,256059356,0.0561573
19061,1,19061,14398666,256059356,0.0562318
19119,1,19119,14417785,256059356,0.0563064
19120,1,19120,14436905,256059356,0.0563811
19129,2,38258,14475163,256059356,0.0565305
19216,1,19216,14494379,256059356,0.0566055
19332,1,19332,14513711,256059356,0.056681
19349,1,19349,14533060,256059356,0.0567566
19405,1,19405,14552465,256059356,0.0568324
19416,1,19416,14571881,256059356,0.0569082
19431,1,19431,14591312,256059356,0.0569841
19466,1,19466,14610778,256059356,0.0570601
19567,1,19567,14630345,256059356,0.0571365
19615,3,58845,14689190,256059356,0.0573663
19647,1,19647,14708837,256059356,0.0574431
19671,1,19671,14728508,256059356,0.0575199
19674,1,19674,14748182,256059356,0.0575967
19687,2,39374,14787556,256059356,0.0577505
19691,1,19691,14807247,256059356,0.0578274
19820,1,19820,14827067,256059356,0.0579048
19827,1,19827,14846894,256059356,0.0579822
19895,1,19895,14866789,256059356,0.0580599
19971,1,19971,14886760,256059356,0.0581379
19984,1,19984,14906744,256059356,0.058216
19990,1,19990,14926734,256059356,0.058294
20020,1,20020,14946754,256059356,0.0583722
20037,1,20037,14966791,256059356,0.0584505
20107,1,20107,14986898,256059356,0.058529
20108,1,20108,15007006,256059356,0.0586075
20117,5,100585,15107591,256059356,0.0590003
20171,1,20171,15127762,256059356,0.0590791
20319,1,20319,15148081,256059356,0.0591585
20367,1,20367,15168448,256059356,0.059238
20524,1,20524,15188972,256059356,0.0593182
20567,1,20567,15209539,256059356,0.0593985
20575,1,20575,15230114,256059356,0.0594788
20642,2,41284,15271398,256059356,0.0596401
20672,1,20672,15292070,256059356,0.0597208
20711,1,20711,15312781,256059356,0.0598017
20782,1,20782,15333563,256059356,0.0598828
20811,1,20811,15354374,256059356,0.0599641
20891,1,20891,15375265,256059356,0.0600457
20923,1,20923,15396188,256059356,0.0601274
20948,1,20948,15417136,256059356,0.0602092
20970,1,20970,15438106,256059356,0.0602911
20983,1,20983,15459089,256059356,0.0603731
21000,1,21000,15480089,256059356,0.0604551
21030,2,42060,15522149,256059356,0.0606193
21051,1,21051,15543200,256059356,0.0607016
21057,1,21057,15564257,256059356,0.0607838
21058,1,21058,15585315,256059356,0.060866
21066,1,21066,15606381,256059356,0.0609483
21077,1,21077,15627458,256059356,0.0610306
21085,1,21085,15648543,256059356,0.061113
21113,1,21113,15669656,256059356,0.0611954
21114,1,21114,15690770,256059356,0.0612779
21119,1,21119,15711889,256059356,0.0613603
21120,3,63360,15775249,256059356,0.0616078
21130,1,21130,15796379,256059356,0.0616903
21152,1,21152,15817531,256059356,0.0617729
21184,2,42368,15859899,256059356,0.0619384
21186,1,21186,15881085,256059356,0.0620211
21277,1,21277,15902362,256059356,0.0621042
21484,1,21484,15923846,256059356,0.0621881
21525,1,21525,15945371,256059356,0.0622722
21571,1,21571,15966942,256059356,0.0623564
21584,1,21584,15988526,256059356,0.0624407
21623,1,21623,16010149,256059356,0.0625251
21627,1,21627,16031776,256059356,0.0626096
21650,2,43300,16075076,256059356,0.0627787
21759,1,21759,16096835,256059356,0.0628637
21779,1,21779,16118614,256059356,0.0629487
21872,1,21872,16140486,256059356,0.0630342
21939,1,21939,16162425,256059356,0.0631198
21991,1,21991,16184416,256059356,0.0632057
22051,1,22051,16206467,256059356,0.0632918
22053,1,22053,16228520,256059356,0.063378
22324,1,22324,16250844,256059356,0.0634651
22341,1,22341,16273185,256059356,0.0635524
22353,3,67059,16340244,256059356,0.0638143
22354,1,22354,16362598,256059356,0.0639016
22454,1,22454,16385052,256059356,0.0639893
22471,2,44942,16429994,256059356,0.0641648
22476,1,22476,16452470,256059356,0.0642526
22602,1,22602,16475072,256059356,0.0643408
22606,2,45212,16520284,256059356,0.0645174
22639,1,22639,16542923,256059356,0.0646058
22952,1,22952,16565875,256059356,0.0646954
23108,1,23108,16588983,256059356,0.0647857
23249,1,23249,16612232,256059356,0.0648765
23318,1,23318,16635550,256059356,0.0649676
23504,2,47008,16682558,256059356,0.0651511
23554,1,23554,16706112,256059356,0.0652431
23632,1,23632,16729744,256059356,0.0653354
23815,1,23815,16753559,256059356,0.0654284
23816,1,23816,16777375,256059356,0.0655214
23840,1,23840,16801215,256059356,0.0656145
23900,1,23900,16825115,256059356,0.0657079
24104,1,24104,16849219,256059356,0.065802
24578,1,24578,16873797,256059356,0.065898
24580,1,24580,16898377,256059356,0.065994
24627,1,24627,16923004,256059356,0.0660902
24720,1,24720,16947724,256059356,0.0661867
24819,1,24819,16972543,256059356,0.0662836
24870,1,24870,16997413,256059356,0.0663808
24943,1,24943,17022356,256059356,0.0664782
24967,1,24967,17047323,256059356,0.0665757
25151,1,25151,17072474,256059356,0.0666739
25155,1,25155,17097629,256059356,0.0667721
25708,1,25708,17123337,256059356,0.0668725
25750,1,25750,17149087,256059356,0.0669731
25929,1,25929,17175016,256059356,0.0670744
26013,1,26013,17201029,256059356,0.0671759
26014,1,26014,17227043,256059356,0.0672775
26074,1,26074,17253117,256059356,0.0673794
26118,1,26118,17279235,256059356,0.0674814
26167,1,26167,17305402,256059356,0.0675836
26284,2,52568,17357970,256059356,0.0677889
26348,1,26348,17384318,256059356,0.0678918
26443,1,26443,17410761,256059356,0.067995
27131,1,27131,17437892,256059356,0.068101
27156,1,27156,17465048,256059356,0.068207
27190,1,27190,17492238,256059356,0.0683132
27270,1,27270,17519508,256059356,0.0684197
27383,1,27383,17546891,256059356,0.0685267
27448,1,27448,17574339,256059356,0.0686338
27846,1,27846,17602185,256059356,0.0687426
27887,1,27887,17630072,256059356,0.0688515
27997,1,27997,17658069,256059356,0.0689608
28001,1,28001,17686070,256059356,0.0690702
28007,1,28007,17714077,256059356,0.0691796
28062,1,28062,17742139,256059356,0.0692892
28222,1,28222,17770361,256059356,0.0693994
28294,5,141470,17911831,256059356,0.0699519
28648,1,28648,17940479,256059356,0.0700638
28821,2,57642,17998121,256059356,0.0702889
28823,1,28823,18026944,256059356,0.0704014
29266,1,29266,18056210,256059356,0.0705157
29330,1,29330,18085540,256059356,0.0706303
29582,1,29582,18115122,256059356,0.0707458
29670,1,29670,18144792,256059356,0.0708617
29709,1,29709,18174501,256059356,0.0709777
29719,1,29719,18204220,256059356,0.0710938
29749,1,29749,18233969,256059356,0.0712099
29808,1,29808,18263777,256059356,0.0713263
29839,1,29839,18293616,256059356,0.0714429
29953,1,29953,18323569,256059356,0.0715598
29968,1,29968,18353537,256059356,0.0716769
30030,1,30030,18383567,256059356,0.0717942
30041,1,30041,18413608,256059356,0.0719115
30042,1,30042,18443650,256059356,0.0720288
30047,1,30047,18473697,256059356,0.0721462
30048,1,30048,18503745,256059356,0.0722635
30050,1,30050,18533795,256059356,0.0723809
30294,1,30294,18564089,256059356,0.0724992
30329,1,30329,18594418,256059356,0.0726176
30693,1,30693,18625111,256059356,0.0727375
30984,1,30984,18656095,256059356,0.0728585
31112,1,31112,18687207,256059356,0.07298
31155,1,31155,18718362,256059356,0.0731017
31566,3,94698,18813060,256059356,0.0734715
31663,1,31663,18844723,256059356,0.0735951
31740,1,31740,18876463,256059356,0.0737191
31896,1,31896,18908359,256059356,0.0738437
31940,1,31940,18940299,256059356,0.0739684
31949,2,63898,19004197,256059356,0.0742179
31953,1,31953,19036150,256059356,0.0743427
32150,1,32150,19068300,256059356,0.0744683
32434,1,32434,19100734,256059356,0.0745949
32450,1,32450,19133184,256059356,0.0747217
32621,1,32621,19165805,256059356,0.0748491
32740,1,32740,19198545,256059356,0.0749769
33039,1,33039,19231584,256059356,0.075106
33145,1,33145,19264729,256059356,0.0752354
33324,1,33324,19298053,256059356,0.0753655
33384,1,33384,19331437,256059356,0.0754959
33401,1,33401,19364838,256059356,0.0756264
33452,1,33452,19398290,256059356,0.075757
33827,1,33827,19432117,256059356,0.0758891
34100,1,34100,19466217,256059356,0.0760223
34196,1,34196,19500413,256059356,0.0761558
34210,1,34210,19534623,256059356,0.0762894
34923,1,34923,19569546,256059356,0.0764258
34970,1,34970,19604516,256059356,0.0765624
35090,1,35090,19639606,256059356,0.0766994
35209,1,35209,19674815,256059356,0.0768369
35227,1,35227,19710042,256059356,0.0769745
35292,1,35292,19745334,256059356,0.0771123
35296,1,35296,19780630,256059356,0.0772502
35629,1,35629,19816259,256059356,0.0773893
36110,2,72220,19888479,256059356,0.0776714
36307,2,72614,19961093,256059356,0.0779549
36316,2,72632,20033725,256059356,0.0782386
36317,1,36317,20070042,256059356,0.0783804
36491,1,36491,20106533,256059356,0.0785229
36970,1,36970,20143503,256059356,0.0786673
37319,1,37319,20180822,256059356,0.0788131
37370,1,37370,20218192,256059356,0.078959
37390,1,37390,20255582,256059356,0.079105
37391,1,37391,20292973,256059356,0.0792511
37535,1,37535,20330508,256059356,0.0793976
38042,1,38042,20368550,256059356,0.0795462
38055,1,38055,20406605,256059356,0.0796948
38309,1,38309,20444914,256059356,0.0798444
38459,2,76918,20521832,256059356,0.0801448
38553,1,38553,20560385,256059356,0.0802954
38620,2,77240,20637625,256059356,0.080597
38638,1,38638,20676263,256059356,0.0807479
38650,1,38650,20714913,256059356,0.0808989
38969,1,38969,20753882,256059356,0.0810511
39005,1,39005,20792887,256059356,0.0812034
39367,1,39367,20832254,256059356,0.0813571
39834,1,39834,20872088,256059356,0.0815127
39926,2,79852,20951940,256059356,0.0818245
40224,1,40224,20992164,256059356,0.0819816
40226,1,40226,21032390,256059356,0.0821387
40470,1,40470,21072860,256059356,0.0822968
40778,1,40778,21113638,256059356,0.082456
40913,1,40913,21154551,256059356,0.0826158
40914,1,40914,21195465,256059356,0.0827756
41355,1,41355,21236820,256059356,0.0829371
41373,1,41373,21278193,256059356,0.0830987
41387,1,41387,21319580,256059356,0.0832603
41422,1,41422,21361002,256059356,0.0834221
41563,1,41563,21402565,256059356,0.0835844
41825,1,41825,21444390,256059356,0.0837477
42574,1,42574,21486964,256059356,0.083914
42711,1,42711,21529675,256059356,0.0840808
42793,1,42793,21572468,256059356,0.0842479
43042,1,43042,21615510,256059356,0.084416
43053,1,43053,21658563,256059356,0.0845842
43314,1,43314,21701877,256059356,0.0847533
43554,2,87108,21788985,256059356,0.0850935
43557,1,43557,21832542,256059356,0.0852636
43572,1,43572,21876114,256059356,0.0854338
43581,2,87162,21963276,256059356,0.0857742
43582,1,43582,22006858,256059356,0.0859444
43583,1,43583,22050441,256059356,0.0861146
43588,1,43588,22094029,256059356,0.0862848
43925,1,43925,22137954,256059356,0.0864563
44399,1,44399,22182353,256059356,0.0866297
44421,1,44421,22226774,256059356,0.0868032
44557,1,44557,22271331,256059356,0.0869772
44562,1,44562,22315893,256059356,0.0871513
44578,1,44578,22360471,256059356,0.0873253
44820,1,44820,22405291,256059356,0.0875004
45212,1,45212,22450503,256059356,0.0876769
45245,1,45245,22495748,256059356,0.0878536
45431,1,45431,22541179,256059356,0.0880311
45469,1,45469,22586648,256059356,0.0882086
45471,1,45471,22632119,256059356,0.0883862
45478,1,45478,22677597,256059356,0.0885638
45479,1,45479,22723076,256059356,0.0887414
45480,1,45480,22768556,256059356,0.0889191
45644,2,91288,22859844,256059356,0.0892756
45661,2,91322,22951166,256059356,0.0896322
45676,1,45676,22996842,256059356,0.0898106
46277,4,185108,23181950,256059356,0.0905335
46523,1,46523,23228473,256059356,0.0907152
46550,1,46550,23275023,256059356,0.090897
47008,1,47008,23322031,256059356,0.0910806
47014,1,47014,23369045,256059356,0.0912642
47377,1,47377,23416422,256059356,0.0914492
47796,1,47796,23464218,256059356,0.0916359
48115,1,48115,23512333,256059356,0.0918238
48221,1,48221,23560554,256059356,0.0920121
48715,1,48715,23609269,256059356,0.0922023
48746,2,97492,23706761,256059356,0.0925831
48759,3,146277,23853038,256059356,0.0931543
48802,1,48802,23901840,256059356,0.0933449
48842,1,48842,23950682,256059356,0.0935357
48861,1,48861,23999543,256059356,0.0937265
48936,1,48936,24048479,256059356,0.0939176
49051,1,49051,24097530,256059356,0.0941092
49318,2,98636,24196166,256059356,0.0944944
49402,1,49402,24245568,256059356,0.0946873
49646,1,49646,24295214,256059356,0.0948812
49915,1,49915,24345129,256059356,0.0950761
50244,1,50244,24395373,256059356,0.0952723
50732,1,50732,24446105,256059356,0.0954705
53332,1,53332,24499437,256059356,0.0956787
53339,1,53339,24552776,256059356,0.095887
53450,1,53450,24606226,256059356,0.0960958
53495,1,53495,24659721,256059356,0.0963047
53991,8,431928,25091649,256059356,0.0979915
54056,2,108112,25199761,256059356,0.0984137
54062,1,54062,25253823,256059356,0.0986249
54336,1,54336,25308159,256059356,0.0988371
54480,1,54480,25362639,256059356,0.0990498
54946,1,54946,25417585,256059356,0.0992644
55874,1,55874,25473459,256059356,0.0994826
55876,1,55876,25529335,256059356,0.0997008
55882,1,55882,25585217,256059356,0.0999191
55986,1,55986,25641203,256059356,0.100138
56768,1,56768,25697971,256059356,0.100359
56832,1,56832,25754803,256059356,0.100581
56895,1,56895,25811698,256059356,0.100804
57020,1,57020,25868718,256059356,0.101026
57023,2,114046,25982764,256059356,0.101472
57666,1,57666,26040430,256059356,0.101697
57922,1,57922,26098352,256059356,0.101923
58233,1,58233,26156585,256059356,0.10215
58525,1,58525,26215110,256059356,0.102379
58700,1,58700,26273810,256059356,0.102608
58724,1,58724,26332534,256059356,0.102838
58894,2,117788,26450322,256059356,0.103298
59040,1,59040,26509362,256059356,0.103528
59586,1,59586,26568948,256059356,0.103761
61240,1,61240,26630188,256059356,0.104
61740,1,61740,26691928,256059356,0.104241
62449,1,62449,26754377,256059356,0.104485
62526,1,62526,26816903,256059356,0.104729
64046,1,64046,26880949,256059356,0.104979
64678,1,64678,26945627,256059356,0.105232
65264,1,65264,27010891,256059356,0.105487
65425,1,65425,27076316,256059356,0.105742
65505,1,65505,27141821,256059356,0.105998
65802,1,65802,27207623,256059356,0.106255
66013,1,66013,27273636,256059356,0.106513
66383,1,66383,27340019,256059356,0.106772
66390,1,66390,27406409,256059356,0.107031
66694,1,66694,27473103,256059356,0.107292
66710,1,66710,27539813,256059356,0.107552
66718,1,66718,27606531,256059356,0.107813
66719,1,66719,27673250,256059356,0.108074
68281,1,68281,27741531,256059356,0.10834
68307,1,68307,27809838,256059356,0.108607
69149,1,69149,27878987,256059356,0.108877
69301,1,69301,27948288,256059356,0.109148
69463,1,69463,28017751,256059356,0.109419
70564,1,70564,28088315,256059356,0.109695
70649,1,70649,28158964,256059356,0.10997
72867,1,72867,28231831,256059356,0.110255
73319,1,73319,28305150,256059356,0.110541
74306,1,74306,28379456,256059356,0.110832
74659,1,74659,28454115,256059356,0.111123
74661,1,74661,28528776,256059356,0.111415
74951,1,74951,28603727,256059356,0.111707
75342,1,75342,28679069,256059356,0.112002
76162,1,76162,28755231,256059356,0.112299
76334,1,76334,28831565,256059356,0.112597
76354,1,76354,28907919,256059356,0.112895
76810,1,76810,28984729,256059356,0.113195
76813,1,76813,29061542,256059356,0.113495
77275,1,77275,29138817,256059356,0.113797
78311,1,78311,29217128,256059356,0.114103
78704,1,78704,29295832,256059356,0.11441
78815,1,78815,29374647,256059356,0.114718
78819,1,78819,29453466,256059356,0.115026
80064,1,80064,29533530,256059356,0.115339
80473,1,80473,29614003,256059356,0.115653
80492,1,80492,29694495,256059356,0.115967
80840,4,323360,30017855,256059356,0.11723
80966,1,80966,30098821,256059356,0.117546
81983,1,81983,30180804,256059356,0.117866
82716,1,82716,30263520,256059356,0.118189
83207,1,83207,30346727,256059356,0.118514
83498,1,83498,30430225,256059356,0.118841
84092,1,84092,30514317,256059356,0.119169
84205,2,168410,30682727,256059356,0.119827
84211,1,84211,30766938,256059356,0.120155
84234,2,168468,30935406,256059356,0.120813
84297,1,84297,31019703,256059356,0.121143
84544,1,84544,31104247,256059356,0.121473
84554,1,84554,31188801,256059356,0.121803
84814,1,84814,31273615,256059356,0.122134
85323,1,85323,31358938,256059356,0.122467
85606,1,85606,31444544,256059356,0.122802
86026,1,86026,31530570,256059356,0.123138
87073,1,87073,31617643,256059356,0.123478
87194,1,87194,31704837,256059356,0.123818
87296,1,87296,31792133,256059356,0.124159
87566,1,87566,31879699,256059356,0.124501
88069,1,88069,31967768,256059356,0.124845
88706,1,88706,32056474,256059356,0.125192
89246,1,89246,32145720,256059356,0.12554
90053,1,90053,32235773,256059356,0.125892
90101,2,180202,32415975,256059356,0.126596
91179,1,91179,32507154,256059356,0.126952
91183,1,91183,32598337,256059356,0.127308
91292,1,91292,32689629,256059356,0.127664
92111,1,92111,32781740,256059356,0.128024
92367,1,92367,32874107,256059356,0.128385
92391,1,92391,32966498,256059356,0.128746
92507,1,92507,33059005,256059356,0.129107
92549,3,277647,33336652,256059356,0.130191
92582,1,92582,33429234,256059356,0.130553
94222,1,94222,33523456,256059356,0.130921
95469,1,95469,33618925,256059356,0.131293
95998,1,95998,33714923,256059356,0.131668
99765,1,99765,33814688,256059356,0.132058
99772,1,99772,33914460,256059356,0.132448
100335,1,100335,34014795,256059356,0.132839
100589,1,100589,34115384,256059356,0.133232
100709,1,100709,34216093,256059356,0.133626
100943,1,100943,34317036,256059356,0.13402
101492,1,101492,34418528,256059356,0.134416
102560,1,102560,34521088,256059356,0.134817
102572,1,102572,34623660,256059356,0.135217
102698,2,205396,34829056,256059356,0.136019
102759,1,102759,34931815,256059356,0.136421
102856,1,102856,35034671,256059356,0.136822
103147,1,103147,35137818,256059356,0.137225
103533,1,103533,35241351,256059356,0.13763
103537,1,103537,35344888,256059356,0.138034
104017,1,104017,35448905,256059356,0.13844
104463,1,104463,35553368,256059356,0.138848
104806,1,104806,35658174,256059356,0.139257
105763,1,105763,35763937,256059356,0.13967
109207,1,109207,35873144,256059356,0.140097
109465,1,109465,35982609,256059356,0.140524
109695,1,109695,36092304,256059356,0.140953
109953,1,109953,36202257,256059356,0.141382
110002,1,110002,36312259,256059356,0.141812
110958,1,110958,36423217,256059356,0.142245
111652,1,111652,36534869,256059356,0.142681
111831,1,111831,36646700,256059356,0.143118
113423,1,113423,36760123,256059356,0.143561
113522,1,113522,36873645,256059356,0.144004
113882,1,113882,36987527,256059356,0.144449
114131,1,114131,37101658,256059356,0.144895
114283,1,114283,37215941,256059356,0.145341
115296,1,115296,37331237,256059356,0.145791
115659,1,115659,37446896,256059356,0.146243
117030,1,117030,37563926,256059356,0.1467
117225,2,234450,37798376,256059356,0.147616
118155,1,118155,37916531,256059356,0.148077
121756,1,121756,38038287,256059356,0.148553
122928,1,122928,38161215,256059356,0.149033
125458,1,125458,38286673,256059356,0.149523
126090,1,126090,38412763,256059356,0.150015
126610,1,126610,38539373,256059356,0.15051
126623,1,126623,38665996,256059356,0.151004
127273,1,127273,38793269,256059356,0.151501
130457,3,391371,39184640,256059356,0.15303
130913,1,130913,39315553,256059356,0.153541
131320,1,131320,39446873,256059356,0.154054
131565,1,131565,39578438,256059356,0.154567
131622,1,131622,39710060,256059356,0.155081
131690,1,131690,39841750,256059356,0.155596
132801,1,132801,39974551,256059356,0.156114
134790,1,134790,40109341,256059356,0.156641
136859,1,136859,40246200,256059356,0.157175
137815,1,137815,40384015,256059356,0.157713
137816,1,137816,40521831,256059356,0.158252
138360,1,138360,40660191,256059356,0.158792
138790,2,277580,40937771,256059356,0.159876
141207,1,141207,41078978,256059356,0.160428
141214,1,141214,41220192,256059356,0.160979
141385,1,141385,41361577,256059356,0.161531
141566,1,141566,41503143,256059356,0.162084
142602,1,142602,41645745,256059356,0.162641
143064,1,143064,41788809,256059356,0.1632
144583,1,144583,41933392,256059356,0.163764
145794,1,145794,42079186,256059356,0.164334
148876,1,148876,42228062,256059356,0.164915
148955,1,148955,42377017,256059356,0.165497
148956,1,148956,42525973,256059356,0.166079
149075,1,149075,42675048,256059356,0.166661
152242,1,152242,42827290,256059356,0.167255
155391,1,155391,42982681,256059356,0.167862
155459,1,155459,43138140,256059356,0.168469
156308,1,156308,43294448,256059356,0.16908
156324,1,156324,43450772,256059356,0.16969
157191,1,157191,43607963,256059356,0.170304
158028,1,158028,43765991,256059356,0.170921
158662,1,158662,43924653,256059356,0.171541
158667,1,158667,44083320,256059356,0.172161
158668,1,158668,44241988,256059356,0.17278
158977,2,317954,44559942,256059356,0.174022
159024,1,159024,44718966,256059356,0.174643
159835,2,319670,45038636,256059356,0.175891
159996,1,159996,45198632,256059356,0.176516
161115,1,161115,45359747,256059356,0.177145
165816,1,165816,45525563,256059356,0.177793
167332,1,167332,45692895,256059356,0.178446
169564,1,169564,45862459,256059356,0.179109
169646,1,169646,46032105,256059356,0.179771
170363,1,170363,46202468,256059356,0.180437
171817,1,171817,46374285,256059356,0.181108
172171,1,172171,46546456,256059356,0.18178
172787,1,172787,46719243,256059356,0.182455
173033,1,173033,46892276,256059356,0.18313
177580,1,177580,47069856,256059356,0.183824
178884,1,178884,47248740,256059356,0.184523
179090,1,179090,47427830,256059356,0.185222
180916,1,180916,47608746,256059356,0.185929
182860,1,182860,47791606,256059356,0.186643
190956,1,190956,47982562,256059356,0.187388
191570,1,191570,48174132,256059356,0.188137
191787,1,191787,48365919,256059356,0.188886
191808,1,191808,48557727,256059356,0.189635
196318,1,196318,48754045,256059356,0.190401
196485,1,196485,48950530,256059356,0.191169
197439,1,197439,49147969,256059356,0.19194
203237,1,203237,49351206,256059356,0.192733
204963,1,204963,49556169,256059356,0.193534
207340,1,207340,49763509,256059356,0.194344
211474,1,211474,49974983,256059356,0.19517
212648,1,212648,50187631,256059356,0.196
213737,1,213737,50401368,256059356,0.196835
222830,1,222830,50624198,256059356,0.197705
223743,1,223743,50847941,256059356,0.198579
228867,1,228867,51076808,256059356,0.199473
234212,1,234212,51311020,256059356,0.200387
234584,1,234584,51545604,256059356,0.201303
236933,1,236933,51782537,256059356,0.202229
239830,1,239830,52022367,256059356,0.203165
242024,1,242024,52264391,256059356,0.20411
244167,1,244167,52508558,256059356,0.205064
245322,1,245322,52753880,256059356,0.206022
246831,1,246831,53000711,256059356,0.206986
248429,1,248429,53249140,256059356,0.207956
253828,1,253828,53502968,256059356,0.208948
260914,1,260914,53763882,256059356,0.209966
260918,1,260918,54024800,256059356,0.210985
262292,1,262292,54287092,256059356,0.21201
262345,1,262345,54549437,256059356,0.213034
265733,1,265733,54815170,256059356,0.214072
267026,1,267026,55082196,256059356,0.215115
281523,1,281523,55363719,256059356,0.216214
284247,1,284247,55647966,256059356,0.217324
291000,1,291000,55938966,256059356,0.218461
292253,1,292253,56231219,256059356,0.219602
294946,1,294946,56526165,256059356,0.220754
299393,1,299393,56825558,256059356,0.221923
299401,1,299401,57124959,256059356,0.223093
299656,1,299656,57424615,256059356,0.224263
313989,1,313989,57738604,256059356,0.225489
316484,1,316484,58055088,256059356,0.226725
316492,1,316492,58371580,256059356,0.227961
324328,1,324328,58695908,256059356,0.229228
341760,1,341760,59037668,256059356,0.230562
344312,1,344312,59381980,256059356,0.231907
347647,4,1390588,60772568,256059356,0.237338
347665,1,347665,61120233,256059356,0.238696
347820,1,347820,61468053,256059356,0.240054
348961,1,348961,61817014,256059356,0.241417
367677,1,367677,62184691,256059356,0.242853
369677,1,369677,62554368,256059356,0.244296
382088,1,382088,62936456,256059356,0.245789
382801,1,382801,63319257,256059356,0.247284
385689,1,385689,63704946,256059356,0.24879
387143,1,387143,64092089,256059356,0.250302
391375,1,391375,64483464,256059356,0.25183
401977,1,401977,64885441,256059356,0.2534
436160,1,436160,65321601,256059356,0.255103
438756,1,438756,65760357,256059356,0.256817
483321,1,483321,66243678,256059356,0.258704
490350,1,490350,66734028,256059356,0.260619
523705,1,523705,67257733,256059356,0.262665
585108,1,585108,67842841,256059356,0.26495
595755,1,595755,68438596,256059356,0.267276
603059,1,603059,69041655,256059356,0.269631
625990,1,625990,69667645,256059356,0.272076
710098,1,710098,70377743,256059356,0.274849
726510,1,726510,71104253,256059356,0.277687
727220,1,727220,71831473,256059356,0.280527
756449,1,756449,72587922,256059356,0.283481
808478,1,808478,73396400,256059356,0.286638
843217,1,843217,74239617,256059356,0.289931
898190,1,898190,75137807,256059356,0.293439
917693,1,917693,76055500,256059356,0.297023
999475,1,999475,77054975,256059356,0.300926
1017900,1,1017900,78072875,256059356,0.304901
1132659,1,1132659,79205534,256059356,0.309325
1179710,1,1179710,80385244,256059356,0.313932
1476012,1,1476012,81861256,256059356,0.319696
1477382,1,1477382,83338638,256059356,0.325466
1807042,1,1807042,85145680,256059356,0.332523
1903490,1,1903490,87049170,256059356,0.339957
2042437,1,2042437,89091607,256059356,0.347933
2141371,1,2141371,91232978,256059356,0.356296
2191509,1,2191509,93424487,256059356,0.364855
3365008,1,3365008,96789495,256059356,0.377996
3500120,1,3500120,100289615,256059356,0.391665
3595070,1,3595070,103884685,256059356,0.405705
3599309,1,3599309,107483994,256059356,0.419762
3867887,1,3867887,111351881,256059356,0.434867
4404559,1,4404559,115756440,256059356,0.452069
4424041,1,4424041,120180481,256059356,0.469346
4430991,1,4430991,124611472,256059356,0.486651
4595327,1,4595327,129206799,256059356,0.504597
14991884,1,14991884,144198683,256059356,0.563146
15423749,1,15423749,159622432,256059356,0.623381
17025842,1,17025842,176648274,256059356,0.689872
19003733,1,19003733,195652007,256059356,0.764088
20555579,1,20555579,216207586,256059356,0.844365
39851770,1,39851770,256059356,256059356,1
