1,39212487,39212487,39212487,256059356,0.153138
2,5838778,11677556,50890043,256059356,0.198743
3,11649315,34947945,85837988,256059356,0.335227
4,3671042,14684168,100522156,256059356,0.392574
5,477347,2386735,102908891,256059356,0.401895
6,853675,5122050,108030941,256059356,0.421898
7,295554,2068878,110099819,256059356,0.429978
8,112353,898824,110998643,256059356,0.433488
9,205753,1851777,112850420,256059356,0.44072
10,79032,790320,113640740,256059356,0.443806
11,51796,569756,114210496,256059356,0.446031
12,72253,867036,115077532,256059356,0.449417
13,42392,551096,115628628,256059356,0.45157
14,28407,397698,116026326,256059356,0.453123
15,31421,471315,116497641,256059356,0.454963
16,23651,378416,116876057,256059356,0.456441
17,18028,306476,117182533,256059356,0.457638
18,20333,365994,117548527,256059356,0.459067
19,16131,306489,117855016,256059356,0.460264
20,14377,287540,118142556,256059356,0.461387
21,14027,294567,118437123,256059356,0.462538
22,12535,275770,118712893,256059356,0.463615
23,10597,243731,118956624,256059356,0.464567
24,11039,264936,119221560,256059356,0.465601
25,9748,243700,119465260,256059356,0.466553
26,8782,228332,119693592,256059356,0.467445
27,8816,238032,119931624,256059356,0.468374
28,8418,235704,120167328,256059356,0.469295
29,7253,210337,120377665,256059356,0.470116
30,7429,222870,120600535,256059356,0.470987
31,7131,221061,120821596,256059356,0.47185
32,6679,213728,121035324,256059356,0.472685
33,6832,225456,121260780,256059356,0.473565
34,6537,222258,121483038,256059356,0.474433
35,5977,209195,121692233,256059356,0.47525
36,6511,234396,121926629,256059356,0.476165
37,6366,235542,122162171,256059356,0.477085
38,5794,220172,122382343,256059356,0.477945
39,5849,228111,122610454,256059356,0.478836
40,5810,232400,122842854,256059356,0.479744
41,5447,223327,123066181,256059356,0.480616
42,5595,234990,123301171,256059356,0.481534
43,5283,227169,123528340,256059356,0.482421
44,5203,228932,123757272,256059356,0.483315
45,5308,238860,123996132,256059356,0.484248
46,4975,228850,124224982,256059356,0.485141
47,4607,216529,124441511,256059356,0.485987
48,4679,224592,124666103,256059356,0.486864
49,4492,220108,124886211,256059356,0.487724
50,4282,214100,125100311,256059356,0.48856
51,4371,222921,125323232,256059356,0.48943
52,4102,213304,125536536,256059356,0.490263
53,3814,202142,125738678,256059356,0.491053
54,3837,207198,125945876,256059356,0.491862
55,3643,200365,126146241,256059356,0.492645
56,3340,187040,126333281,256059356,0.493375
57,3110,177270,126510551,256059356,0.494067
58,3028,175624,126686175,256059356,0.494753
59,2676,157884,126844059,256059356,0.49537
60,2679,160740,127004799,256059356,0.495997
61,2485,151585,127156384,256059356,0.496589
62,2278,141236,127297620,256059356,0.497141
63,2207,139041,127436661,256059356,0.497684
64,2142,137088,127573749,256059356,0.498219
65,1984,128960,127702709,256059356,0.498723
66,1898,125268,127827977,256059356,0.499212
67,1894,126898,127954875,256059356,0.499708
68,1738,118184,128073059,256059356,0.500169
69,1940,133860,128206919,256059356,0.500692
70,1829,128030,128334949,256059356,0.501192
71,1608,114168,128449117,256059356,0.501638
72,1666,119952,128569069,256059356,0.502107
73,1604,117092,128686161,256059356,0.502564
74,1456,107744,128793905,256059356,0.502985
75,1425,106875,128900780,256059356,0.503402
76,1508,114608,129015388,256059356,0.50385
77,1357,104489,129119877,256059356,0.504258
78,1363,106314,129226191,256059356,0.504673
79,1360,107440,129333631,256059356,0.505092
80,1214,97120,129430751,256059356,0.505472
81,1207,97767,129528518,256059356,0.505853
82,1244,102008,129630526,256059356,0.506252
83,1145,95035,129725561,256059356,0.506623
84,1127,94668,129820229,256059356,0.506993
85,1127,95795,129916024,256059356,0.507367
86,1065,91590,130007614,256059356,0.507725
87,1077,93699,130101313,256059356,0.50809
88,1113,97944,130199257,256059356,0.508473
89,1008,89712,130288969,256059356,0.508823
90,1001,90090,130379059,256059356,0.509175
91,987,89817,130468876,256059356,0.509526
92,945,86940,130555816,256059356,0.509865
93,951,88443,130644259,256059356,0.510211
94,953,89582,130733841,256059356,0.510561
95,916,87020,130820861,256059356,0.510901
96,886,85056,130905917,256059356,0.511233
97,846,82062,130987979,256059356,0.511553
98,853,83594,131071573,256059356,0.51188
99,818,80982,131152555,256059356,0.512196
100,852,85200,131237755,256059356,0.512529
101,774,78174,131315929,256059356,0.512834
102,792,80784,131396713,256059356,0.513149
103,758,78074,131474787,256059356,0.513454
104,703,73112,131547899,256059356,0.51374
105,728,76440,131624339,256059356,0.514038
106,680,72080,131696419,256059356,0.51432
107,648,69336,131765755,256059356,0.514591
108,658,71064,131836819,256059356,0.514868
109,692,75428,131912247,256059356,0.515163
110,612,67320,131979567,256059356,0.515426
111,610,67710,132047277,256059356,0.51569
112,651,72912,132120189,256059356,0.515975
113,627,70851,132191040,256059356,0.516252
114,590,67260,132258300,256059356,0.516514
115,594,68310,132326610,256059356,0.516781
116,557,64612,132391222,256059356,0.517033
117,574,67158,132458380,256059356,0.517296
118,559,65962,132524342,256059356,0.517553
119,558,66402,132590744,256059356,0.517813
120,533,63960,132654704,256059356,0.518062
121,533,64493,132719197,256059356,0.518314
122,472,57584,132776781,256059356,0.518539
123,520,63960,132840741,256059356,0.518789
124,542,67208,132907949,256059356,0.519051
125,469,58625,132966574,256059356,0.51928
126,511,64386,133030960,256059356,0.519532
127,490,62230,133093190,256059356,0.519775
128,437,55936,133149126,256059356,0.519993
129,502,64758,133213884,256059356,0.520246
130,450,58500,133272384,256059356,0.520475
131,431,56461,133328845,256059356,0.520695
132,510,67320,133396165,256059356,0.520958
133,446,59318,133455483,256059356,0.52119
134,457,61238,133516721,256059356,0.521429
135,437,58995,133575716,256059356,0.521659
136,429,58344,133634060,256059356,0.521887
137,397,54389,133688449,256059356,0.522099
138,416,57408,133745857,256059356,0.522324
139,405,56295,133802152,256059356,0.522543
140,383,53620,133855772,256059356,0.522753
141,412,58092,133913864,256059356,0.52298
142,413,58646,133972510,256059356,0.523209
143,429,61347,134033857,256059356,0.523448
144,336,48384,134082241,256059356,0.523637
145,331,47995,134130236,256059356,0.523825
146,374,54604,134184840,256059356,0.524038
147,364,53508,134238348,256059356,0.524247
148,366,54168,134292516,256059356,0.524459
149,371,55279,134347795,256059356,0.524674
150,358,53700,134401495,256059356,0.524884
151,353,53303,134454798,256059356,0.525092
152,322,48944,134503742,256059356,0.525283
153,330,50490,134554232,256059356,0.525481
154,329,50666,134604898,256059356,0.525678
155,320,49600,134654498,256059356,0.525872
156,334,52104,134706602,256059356,0.526076
157,350,54950,134761552,256059356,0.52629
158,280,44240,134805792,256059356,0.526463
159,317,50403,134856195,256059356,0.52666
160,332,53120,134909315,256059356,0.526867
161,298,47978,134957293,256059356,0.527055
162,267,43254,135000547,256059356,0.527224
163,293,47759,135048306,256059356,0.52741
164,317,51988,135100294,256059356,0.527613
165,308,50820,135151114,256059356,0.527812
166,289,47974,135199088,256059356,0.527999
167,306,51102,135250190,256059356,0.528199
168,281,47208,135297398,256059356,0.528383
169,280,47320,135344718,256059356,0.528568
170,270,45900,135390618,256059356,0.528747
171,255,43605,135434223,256059356,0.528917
172,276,47472,135481695,256059356,0.529103
173,274,47402,135529097,256059356,0.529288
174,262,45588,135574685,256059356,0.529466
175,259,45325,135620010,256059356,0.529643
176,269,47344,135667354,256059356,0.529828
177,262,46374,135713728,256059356,0.530009
178,251,44678,135758406,256059356,0.530183
179,243,43497,135801903,256059356,0.530353
180,211,37980,135839883,256059356,0.530502
181,221,40001,135879884,256059356,0.530658
182,225,40950,135920834,256059356,0.530818
183,237,43371,135964205,256059356,0.530987
184,220,40480,136004685,256059356,0.531145
185,246,45510,136050195,256059356,0.531323
186,238,44268,136094463,256059356,0.531496
187,214,40018,136134481,256059356,0.531652
188,226,42488,136176969,256059356,0.531818
189,223,42147,136219116,256059356,0.531983
190,230,43700,136262816,256059356,0.532153
191,244,46604,136309420,256059356,0.532335
192,193,37056,136346476,256059356,0.53248
193,257,49601,136396077,256059356,0.532674
194,244,47336,136443413,256059356,0.532859
195,224,43680,136487093,256059356,0.533029
196,228,44688,136531781,256059356,0.533204
197,243,47871,136579652,256059356,0.533391
198,233,46134,136625786,256059356,0.533571
199,244,48556,136674342,256059356,0.53376
200,221,44200,136718542,256059356,0.533933
201,212,42612,136761154,256059356,0.534099
202,225,45450,136806604,256059356,0.534277
203,210,42630,136849234,256059356,0.534443
204,243,49572,136898806,256059356,0.534637
205,210,43050,136941856,256059356,0.534805
206,230,47380,136989236,256059356,0.53499
207,226,46782,137036018,256059356,0.535173
208,218,45344,137081362,256059356,0.53535
209,214,44726,137126088,256059356,0.535525
210,183,38430,137164518,256059356,0.535675
211,220,46420,137210938,256059356,0.535856
212,195,41340,137252278,256059356,0.536017
213,190,40470,137292748,256059356,0.536175
214,196,41944,137334692,256059356,0.536339
215,176,37840,137372532,256059356,0.536487
216,179,38664,137411196,256059356,0.536638
217,165,35805,137447001,256059356,0.536778
218,163,35534,137482535,256059356,0.536917
219,175,38325,137520860,256059356,0.537066
220,174,38280,137559140,256059356,0.537216
221,180,39780,137598920,256059356,0.537371
222,165,36630,137635550,256059356,0.537514
223,174,38802,137674352,256059356,0.537666
224,177,39648,137714000,256059356,0.537821
225,171,38475,137752475,256059356,0.537971
226,144,32544,137785019,256059356,0.538098
227,158,35866,137820885,256059356,0.538238
228,137,31236,137852121,256059356,0.53836
229,154,35266,137887387,256059356,0.538498
230,147,33810,137921197,256059356,0.53863
231,164,37884,137959081,256059356,0.538778
232,140,32480,137991561,256059356,0.538905
233,165,38445,138030006,256059356,0.539055
234,166,38844,138068850,256059356,0.539206
235,151,35485,138104335,256059356,0.539345
236,134,31624,138135959,256059356,0.539469
237,159,37683,138173642,256059356,0.539616
238,155,36890,138210532,256059356,0.53976
239,159,38001,138248533,256059356,0.539908
240,151,36240,138284773,256059356,0.54005
241,160,38560,138323333,256059356,0.5402
242,149,36058,138359391,256059356,0.540341
243,130,31590,138390981,256059356,0.540464
244,146,35624,138426605,256059356,0.540604
245,150,36750,138463355,256059356,0.540747
246,160,39360,138502715,256059356,0.540901
247,152,37544,138540259,256059356,0.541047
248,140,34720,138574979,256059356,0.541183
249,116,28884,138603863,256059356,0.541296
250,155,38750,138642613,256059356,0.541447
251,147,36897,138679510,256059356,0.541591
252,121,30492,138710002,256059356,0.54171
253,122,30866,138740868,256059356,0.541831
254,138,35052,138775920,256059356,0.541968
255,114,29070,138804990,256059356,0.542081
256,128,32768,138837758,256059356,0.542209
257,117,30069,138867827,256059356,0.542327
258,140,36120,138903947,256059356,0.542468
259,142,36778,138940725,256059356,0.542611
260,109,28340,138969065,256059356,0.542722
261,119,31059,139000124,256059356,0.542843
262,113,29606,139029730,256059356,0.542959
263,133,34979,139064709,256059356,0.543096
264,112,29568,139094277,256059356,0.543211
265,134,35510,139129787,256059356,0.54335
266,117,31122,139160909,256059356,0.543471
267,120,32040,139192949,256059356,0.543596
268,106,28408,139221357,256059356,0.543707
269,113,30397,139251754,256059356,0.543826
270,109,29430,139281184,256059356,0.543941
271,103,27913,139309097,256059356,0.54405
272,92,25024,139334121,256059356,0.544148
273,122,33306,139367427,256059356,0.544278
274,127,34798,139402225,256059356,0.544414
275,123,33825,139436050,256059356,0.544546
276,104,28704,139464754,256059356,0.544658
277,110,30470,139495224,256059356,0.544777
278,112,31136,139526360,256059356,0.544899
279,98,27342,139553702,256059356,0.545005
280,117,32760,139586462,256059356,0.545133
281,107,30067,139616529,256059356,0.545251
282,92,25944,139642473,256059356,0.545352
283,102,28866,139671339,256059356,0.545465
284,106,30104,139701443,256059356,0.545582
285,108,30780,139732223,256059356,0.545702
286,110,31460,139763683,256059356,0.545825
287,100,28700,139792383,256059356,0.545937
288,96,27648,139820031,256059356,0.546045
289,102,29478,139849509,256059356,0.546161
290,103,29870,139879379,256059356,0.546277
291,97,28227,139907606,256059356,0.546387
292,105,30660,139938266,256059356,0.546507
293,104,30472,139968738,256059356,0.546626
294,111,32634,140001372,256059356,0.546754
295,101,29795,140031167,256059356,0.54687
296,108,31968,140063135,256059356,0.546995
297,105,31185,140094320,256059356,0.547117
298,104,30992,140125312,256059356,0.547238
299,80,23920,140149232,256059356,0.547331
300,111,33300,140182532,256059356,0.547461
301,105,31605,140214137,256059356,0.547585
302,97,29294,140243431,256059356,0.547699
303,101,30603,140274034,256059356,0.547818
304,90,27360,140301394,256059356,0.547925
305,101,30805,140332199,256059356,0.548046
306,76,23256,140355455,256059356,0.548136
307,86,26402,140381857,256059356,0.54824
308,76,23408,140405265,256059356,0.548331
309,108,33372,140438637,256059356,0.548461
310,72,22320,140460957,256059356,0.548548
311,96,29856,140490813,256059356,0.548665
312,83,25896,140516709,256059356,0.548766
313,80,25040,140541749,256059356,0.548864
314,79,24806,140566555,256059356,0.548961
315,90,28350,140594905,256059356,0.549072
316,83,26228,140621133,256059356,0.549174
317,70,22190,140643323,256059356,0.549261
318,83,26394,140669717,256059356,0.549364
319,89,28391,140698108,256059356,0.549475
320,84,26880,140724988,256059356,0.54958
321,86,27606,140752594,256059356,0.549687
322,86,27692,140780286,256059356,0.549796
323,81,26163,140806449,256059356,0.549898
324,99,32076,140838525,256059356,0.550023
325,95,30875,140869400,256059356,0.550144
326,85,27710,140897110,256059356,0.550252
327,82,26814,140923924,256059356,0.550356
328,65,21320,140945244,256059356,0.55044
329,81,26649,140971893,256059356,0.550544
330,92,30360,141002253,256059356,0.550662
331,76,25156,141027409,256059356,0.550761
332,78,25896,141053305,256059356,0.550862
333,100,33300,141086605,256059356,0.550992
334,92,30728,141117333,256059356,0.551112
335,66,22110,141139443,256059356,0.551198
336,89,29904,141169347,256059356,0.551315
337,68,22916,141192263,256059356,0.551404
338,88,29744,141222007,256059356,0.551521
339,77,26103,141248110,256059356,0.551623
340,63,21420,141269530,256059356,0.551706
341,81,27621,141297151,256059356,0.551814
342,74,25308,141322459,256059356,0.551913
343,82,28126,141350585,256059356,0.552023
344,74,25456,141376041,256059356,0.552122
345,60,20700,141396741,256059356,0.552203
346,73,25258,141421999,256059356,0.552302
347,75,26025,141448024,256059356,0.552403
348,70,24360,141472384,256059356,0.552498
349,68,23732,141496116,256059356,0.552591
350,69,24150,141520266,256059356,0.552685
351,82,28782,141549048,256059356,0.552798
352,61,21472,141570520,256059356,0.552882
353,86,30358,141600878,256059356,0.553
354,63,22302,141623180,256059356,0.553087
355,90,31950,141655130,256059356,0.553212
356,73,25988,141681118,256059356,0.553314
357,67,23919,141705037,256059356,0.553407
358,67,23986,141729023,256059356,0.553501
359,72,25848,141754871,256059356,0.553602
360,64,23040,141777911,256059356,0.553692
361,65,23465,141801376,256059356,0.553783
362,68,24616,141825992,256059356,0.553879
363,79,28677,141854669,256059356,0.553991
364,60,21840,141876509,256059356,0.554077
365,61,22265,141898774,256059356,0.554164
366,79,28914,141927688,256059356,0.554277
367,80,29360,141957048,256059356,0.554391
368,78,28704,141985752,256059356,0.554503
369,110,40590,142026342,256059356,0.554662
370,81,29970,142056312,256059356,0.554779
371,85,31535,142087847,256059356,0.554902
372,68,25296,142113143,256059356,0.555001
373,81,30213,142143356,256059356,0.555119
374,57,21318,142164674,256059356,0.555202
375,70,26250,142190924,256059356,0.555305
376,67,25192,142216116,256059356,0.555403
377,60,22620,142238736,256059356,0.555491
378,68,25704,142264440,256059356,0.555592
379,60,22740,142287180,256059356,0.55568
380,55,20900,142308080,256059356,0.555762
381,80,30480,142338560,256059356,0.555881
382,56,21392,142359952,256059356,0.555965
383,76,29108,142389060,256059356,0.556078
384,54,20736,142409796,256059356,0.556159
385,58,22330,142432126,256059356,0.556247
386,59,22774,142454900,256059356,0.556335
387,87,33669,142488569,256059356,0.556467
388,50,19400,142507969,256059356,0.556543
389,61,23729,142531698,256059356,0.556635
390,48,18720,142550418,256059356,0.556708
391,59,23069,142573487,256059356,0.556799
392,54,21168,142594655,256059356,0.556881
393,61,23973,142618628,256059356,0.556975
394,67,26398,142645026,256059356,0.557078
395,69,27255,142672281,256059356,0.557184
396,47,18612,142690893,256059356,0.557257
397,65,25805,142716698,256059356,0.557358
398,71,28258,142744956,256059356,0.557468
399,50,19950,142764906,256059356,0.557546
400,68,27200,142792106,256059356,0.557652
401,67,26867,142818973,256059356,0.557757
402,59,23718,142842691,256059356,0.55785
403,61,24583,142867274,256059356,0.557946
404,52,21008,142888282,256059356,0.558028
405,60,24300,142912582,256059356,0.558123
406,55,22330,142934912,256059356,0.55821
407,67,27269,142962181,256059356,0.558317
408,56,22848,142985029,256059356,0.558406
409,63,25767,143010796,256059356,0.558506
410,49,20090,143030886,256059356,0.558585
411,53,21783,143052669,256059356,0.55867
412,51,21012,143073681,256059356,0.558752
413,52,21476,143095157,256059356,0.558836
414,39,16146,143111303,256059356,0.558899
415,58,24070,143135373,256059356,0.558993
416,49,20384,143155757,256059356,0.559073
417,45,18765,143174522,256059356,0.559146
418,63,26334,143200856,256059356,0.559249
419,57,23883,143224739,256059356,0.559342
420,53,22260,143246999,256059356,0.559429
421,49,20629,143267628,256059356,0.559509
422,57,24054,143291682,256059356,0.559603
423,49,20727,143312409,256059356,0.559684
424,53,22472,143334881,256059356,0.559772
425,74,31450,143366331,256059356,0.559895
426,52,22152,143388483,256059356,0.559981
427,59,25193,143413676,256059356,0.56008
428,63,26964,143440640,256059356,0.560185
429,61,26169,143466809,256059356,0.560287
430,42,18060,143484869,256059356,0.560358
431,49,21119,143505988,256059356,0.56044
432,45,19440,143525428,256059356,0.560516
433,49,21217,143546645,256059356,0.560599
434,39,16926,143563571,256059356,0.560665
435,35,15225,143578796,256059356,0.560725
436,54,23544,143602340,256059356,0.560817
437,61,26657,143628997,256059356,0.560921
438,37,16206,143645203,256059356,0.560984
439,50,21950,143667153,256059356,0.56107
440,46,20240,143687393,256059356,0.561149
441,40,17640,143705033,256059356,0.561218
442,39,17238,143722271,256059356,0.561285
443,53,23479,143745750,256059356,0.561377
444,58,25752,143771502,256059356,0.561477
445,53,23585,143795087,256059356,0.561569
446,42,18732,143813819,256059356,0.561643
447,41,18327,143832146,256059356,0.561714
448,52,23296,143855442,256059356,0.561805
449,55,24695,143880137,256059356,0.561902
450,37,16650,143896787,256059356,0.561967
451,50,22550,143919337,256059356,0.562055
452,32,14464,143933801,256059356,0.562111
453,46,20838,143954639,256059356,0.562192
454,58,26332,143980971,256059356,0.562295
455,55,25025,144005996,256059356,0.562393
456,60,27360,144033356,256059356,0.5625
457,54,24678,144058034,256059356,0.562596
458,41,18778,144076812,256059356,0.56267
459,39,17901,144094713,256059356,0.562739
460,57,26220,144120933,256059356,0.562842
461,53,24433,144145366,256059356,0.562937
462,46,21252,144166618,256059356,0.56302
463,41,18983,144185601,256059356,0.563094
464,46,21344,144206945,256059356,0.563178
465,56,26040,144232985,256059356,0.563279
466,42,19572,144252557,256059356,0.563356
467,37,17279,144269836,256059356,0.563423
468,36,16848,144286684,256059356,0.563489
469,57,26733,144313417,256059356,0.563594
470,32,15040,144328457,256059356,0.563652
471,40,18840,144347297,256059356,0.563726
472,54,25488,144372785,256059356,0.563825
473,48,22704,144395489,256059356,0.563914
474,35,16590,144412079,256059356,0.563979
475,44,20900,144432979,256059356,0.564061
476,45,21420,144454399,256059356,0.564144
477,36,17172,144471571,256059356,0.564211
478,30,14340,144485911,256059356,0.564267
479,39,18681,144504592,256059356,0.56434
480,58,27840,144532432,256059356,0.564449
481,36,17316,144549748,256059356,0.564517
482,39,18798,144568546,256059356,0.56459
483,41,19803,144588349,256059356,0.564667
484,40,19360,144607709,256059356,0.564743
485,44,21340,144629049,256059356,0.564826
486,40,19440,144648489,256059356,0.564902
487,44,21428,144669917,256059356,0.564986
488,41,20008,144689925,256059356,0.565064
489,46,22494,144712419,256059356,0.565152
490,50,24500,144736919,256059356,0.565248
491,31,15221,144752140,256059356,0.565307
492,37,18204,144770344,256059356,0.565378
493,31,15283,144785627,256059356,0.565438
494,39,19266,144804893,256059356,0.565513
495,41,20295,144825188,256059356,0.565592
496,33,16368,144841556,256059356,0.565656
497,39,19383,144860939,256059356,0.565732
498,28,13944,144874883,256059356,0.565786
499,39,19461,144894344,256059356,0.565862
500,41,20500,144914844,256059356,0.565942
501,32,16032,144930876,256059356,0.566005
502,39,19578,144950454,256059356,0.566081
503,27,13581,144964035,256059356,0.566134
504,42,21168,144985203,256059356,0.566217
505,44,22220,145007423,256059356,0.566304
506,39,19734,145027157,256059356,0.566381
507,23,11661,145038818,256059356,0.566427
508,45,22860,145061678,256059356,0.566516
509,51,25959,145087637,256059356,0.566617
510,38,19380,145107017,256059356,0.566693
511,44,22484,145129501,256059356,0.566781
512,40,20480,145149981,256059356,0.566861
513,24,12312,145162293,256059356,0.566909
514,36,18504,145180797,256059356,0.566981
515,37,19055,145199852,256059356,0.567055
516,37,19092,145218944,256059356,0.56713
517,26,13442,145232386,256059356,0.567183
518,36,18648,145251034,256059356,0.567255
519,26,13494,145264528,256059356,0.567308
520,34,17680,145282208,256059356,0.567377
521,31,16151,145298359,256059356,0.56744
522,45,23490,145321849,256059356,0.567532
523,34,17782,145339631,256059356,0.567601
524,36,18864,145358495,256059356,0.567675
525,36,18900,145377395,256059356,0.567749
526,31,16306,145393701,256059356,0.567812
527,28,14756,145408457,256059356,0.56787
528,43,22704,145431161,256059356,0.567959
529,30,15870,145447031,256059356,0.568021
530,26,13780,145460811,256059356,0.568075
531,33,17523,145478334,256059356,0.568143
532,27,14364,145492698,256059356,0.568199
533,37,19721,145512419,256059356,0.568276
534,27,14418,145526837,256059356,0.568332
535,33,17655,145544492,256059356,0.568401
536,30,16080,145560572,256059356,0.568464
537,36,19332,145579904,256059356,0.56854
538,26,13988,145593892,256059356,0.568594
539,38,20482,145614374,256059356,0.568674
540,28,15120,145629494,256059356,0.568733
541,34,18394,145647888,256059356,0.568805
542,25,13550,145661438,256059356,0.568858
543,38,20634,145682072,256059356,0.568939
544,32,17408,145699480,256059356,0.569007
545,32,17440,145716920,256059356,0.569075
546,37,20202,145737122,256059356,0.569154
547,33,18051,145755173,256059356,0.569224
548,31,16988,145772161,256059356,0.569291
549,33,18117,145790278,256059356,0.569361
550,36,19800,145810078,256059356,0.569439
551,32,17632,145827710,256059356,0.569507
552,30,16560,145844270,256059356,0.569572
553,27,14931,145859201,256059356,0.56963
554,50,27700,145886901,256059356,0.569739
555,42,23310,145910211,256059356,0.56983
556,20,11120,145921331,256059356,0.569873
557,35,19495,145940826,256059356,0.569949
558,39,21762,145962588,256059356,0.570034
559,34,19006,145981594,256059356,0.570108
560,23,12880,145994474,256059356,0.570159
561,34,19074,146013548,256059356,0.570233
562,40,22480,146036028,256059356,0.570321
563,33,18579,146054607,256059356,0.570394
564,27,15228,146069835,256059356,0.570453
565,25,14125,146083960,256059356,0.570508
566,26,14716,146098676,256059356,0.570566
567,31,17577,146116253,256059356,0.570634
568,27,15336,146131589,256059356,0.570694
569,29,16501,146148090,256059356,0.570759
570,28,15960,146164050,256059356,0.570821
571,30,17130,146181180,256059356,0.570888
572,34,19448,146200628,256059356,0.570964
573,33,18909,146219537,256059356,0.571038
574,29,16646,146236183,256059356,0.571103
575,32,18400,146254583,256059356,0.571175
576,28,16128,146270711,256059356,0.571238
577,22,12694,146283405,256059356,0.571287
578,35,20230,146303635,256059356,0.571366
579,22,12738,146316373,256059356,0.571416
580,23,13340,146329713,256059356,0.571468
581,39,22659,146352372,256059356,0.571556
582,22,12804,146365176,256059356,0.571606
583,32,18656,146383832,256059356,0.571679
584,32,18688,146402520,256059356,0.571752
585,28,16380,146418900,256059356,0.571816
586,37,21682,146440582,256059356,0.571901
587,31,18197,146458779,256059356,0.571972
588,28,16464,146475243,256059356,0.572036
589,24,14136,146489379,256059356,0.572091
590,27,15930,146505309,256059356,0.572154
591,27,15957,146521266,256059356,0.572216
592,19,11248,146532514,256059356,0.57226
593,26,15418,146547932,256059356,0.57232
594,28,16632,146564564,256059356,0.572385
595,34,20230,146584794,256059356,0.572464
596,28,16688,146601482,256059356,0.572529
597,27,16119,146617601,256059356,0.572592
598,25,14950,146632551,256059356,0.572651
599,26,15574,146648125,256059356,0.572711
600,26,15600,146663725,256059356,0.572772
601,31,18631,146682356,256059356,0.572845
602,18,10836,146693192,256059356,0.572887
603,26,15678,146708870,256059356,0.572949
604,23,13892,146722762,256059356,0.573003
605,28,16940,146739702,256059356,0.573069
606,25,15150,146754852,256059356,0.573128
607,28,16996,146771848,256059356,0.573195
608,41,24928,146796776,256059356,0.573292
609,27,16443,146813219,256059356,0.573356
610,18,10980,146824199,256059356,0.573399
611,31,18941,146843140,256059356,0.573473
612,36,22032,146865172,256059356,0.573559
613,17,10421,146875593,256059356,0.5736
614,21,12894,146888487,256059356,0.57365
615,23,14145,146902632,256059356,0.573705
616,18,11088,146913720,256059356,0.573749
617,24,14808,146928528,256059356,0.573807
618,22,13596,146942124,256059356,0.57386
619,18,11142,146953266,256059356,0.573903
620,26,16120,146969386,256059356,0.573966
621,29,18009,146987395,256059356,0.574036
622,22,13684,147001079,256059356,0.57409
623,31,19313,147020392,256059356,0.574165
624,20,12480,147032872,256059356,0.574214
625,22,13750,147046622,256059356,0.574268
626,21,13146,147059768,256059356,0.574319
627,19,11913,147071681,256059356,0.574366
628,24,15072,147086753,256059356,0.574424
629,19,11951,147098704,256059356,0.574471
630,29,18270,147116974,256059356,0.574542
631,20,12620,147129594,256059356,0.574592
632,28,17696,147147290,256059356,0.574661
633,25,15825,147163115,256059356,0.574723
634,21,13314,147176429,256059356,0.574775
635,33,20955,147197384,256059356,0.574856
636,23,14628,147212012,256059356,0.574914
637,18,11466,147223478,256059356,0.574958
638,24,15312,147238790,256059356,0.575018
639,24,15336,147254126,256059356,0.575078
640,15,9600,147263726,256059356,0.575116
641,24,15384,147279110,256059356,0.575176
642,22,14124,147293234,256059356,0.575231
643,31,19933,147313167,256059356,0.575309
644,13,8372,147321539,256059356,0.575341
645,26,16770,147338309,256059356,0.575407
646,22,14212,147352521,256059356,0.575462
647,20,12940,147365461,256059356,0.575513
648,16,10368,147375829,256059356,0.575553
649,33,21417,147397246,256059356,0.575637
650,22,14300,147411546,256059356,0.575693
651,15,9765,147421311,256059356,0.575731
652,15,9780,147431091,256059356,0.575769
653,32,20896,147451987,256059356,0.575851
654,21,13734,147465721,256059356,0.575904
655,17,11135,147476856,256059356,0.575948
656,22,14432,147491288,256059356,0.576004
657,23,15111,147506399,256059356,0.576063
658,24,15792,147522191,256059356,0.576125
659,18,11862,147534053,256059356,0.576171
660,27,17820,147551873,256059356,0.576241
661,31,20491,147572364,256059356,0.576321
662,13,8606,147580970,256059356,0.576355
663,20,13260,147594230,256059356,0.576406
664,14,9296,147603526,256059356,0.576443
665,17,11305,147614831,256059356,0.576487
666,21,13986,147628817,256059356,0.576541
667,24,16008,147644825,256059356,0.576604
668,21,14028,147658853,256059356,0.576659
669,19,12711,147671564,256059356,0.576708
670,17,11390,147682954,256059356,0.576753
671,12,8052,147691006,256059356,0.576784
672,21,14112,147705118,256059356,0.576839
673,22,14806,147719924,256059356,0.576897
674,25,16850,147736774,256059356,0.576963
675,20,13500,147750274,256059356,0.577016
676,21,14196,147764470,256059356,0.577071
677,16,10832,147775302,256059356,0.577113
678,17,11526,147786828,256059356,0.577158
679,16,10864,147797692,256059356,0.577201
680,15,10200,147807892,256059356,0.577241
681,34,23154,147831046,256059356,0.577331
682,19,12958,147844004,256059356,0.577382
683,15,10245,147854249,256059356,0.577422
684,22,15048,147869297,256059356,0.577481
685,32,21920,147891217,256059356,0.577566
686,15,10290,147901507,256059356,0.577606
687,21,14427,147915934,256059356,0.577663
688,11,7568,147923502,256059356,0.577692
689,12,8268,147931770,256059356,0.577725
690,13,8970,147940740,256059356,0.57776
691,16,11056,147951796,256059356,0.577803
692,14,9688,147961484,256059356,0.577841
693,16,11088,147972572,256059356,0.577884
694,15,10410,147982982,256059356,0.577925
695,12,8340,147991322,256059356,0.577957
696,18,12528,148003850,256059356,0.578006
697,13,9061,148012911,256059356,0.578041
698,28,19544,148032455,256059356,0.578118
699,18,12582,148045037,256059356,0.578167
700,28,19600,148064637,256059356,0.578243
701,26,18226,148082863,256059356,0.578315
702,17,11934,148094797,256059356,0.578361
703,22,15466,148110263,256059356,0.578422
704,20,14080,148124343,256059356,0.578477
705,24,16920,148141263,256059356,0.578543
706,19,13414,148154677,256059356,0.578595
707,15,10605,148165282,256059356,0.578636
708,16,11328,148176610,256059356,0.578681
709,15,10635,148187245,256059356,0.578722
710,14,9940,148197185,256059356,0.578761
711,20,14220,148211405,256059356,0.578817
712,17,12104,148223509,256059356,0.578864
713,25,17825,148241334,256059356,0.578933
714,16,11424,148252758,256059356,0.578978
715,15,10725,148263483,256059356,0.57902
716,12,8592,148272075,256059356,0.579054
717,18,12906,148284981,256059356,0.579104
718,26,18668,148303649,256059356,0.579177
719,26,18694,148322343,256059356,0.57925
720,28,20160,148342503,256059356,0.579329
721,13,9373,148351876,256059356,0.579365
722,14,10108,148361984,256059356,0.579405
723,16,11568,148373552,256059356,0.57945
724,12,8688,148382240,256059356,0.579484
725,21,15225,148397465,256059356,0.579543
726,18,13068,148410533,256059356,0.579594
727,17,12359,148422892,256059356,0.579643
728,22,16016,148438908,256059356,0.579705
729,11,8019,148446927,256059356,0.579736
730,30,21900,148468827,256059356,0.579822
731,20,14620,148483447,256059356,0.579879
732,28,20496,148503943,256059356,0.579959
733,16,11728,148515671,256059356,0.580005
734,20,14680,148530351,256059356,0.580062
735,25,18375,148548726,256059356,0.580134
736,12,8832,148557558,256059356,0.580168
737,13,9581,148567139,256059356,0.580206
738,24,17712,148584851,256059356,0.580275
739,21,15519,148600370,256059356,0.580336
740,14,10360,148610730,256059356,0.580376
741,22,16302,148627032,256059356,0.58044
742,11,8162,148635194,256059356,0.580472
743,18,13374,148648568,256059356,0.580524
744,23,17112,148665680,256059356,0.580591
745,16,11920,148677600,256059356,0.580637
746,17,12682,148690282,256059356,0.580687
747,16,11952,148702234,256059356,0.580733
748,19,14212,148716446,256059356,0.580789
749,13,9737,148726183,256059356,0.580827
750,21,15750,148741933,256059356,0.580888
751,17,12767,148754700,256059356,0.580938
752,15,11280,148765980,256059356,0.580982
753,21,15813,148781793,256059356,0.581044
754,12,9048,148790841,256059356,0.581079
755,22,16610,148807451,256059356,0.581144
756,14,10584,148818035,256059356,0.581186
757,23,17411,148835446,256059356,0.581254
758,15,11370,148846816,256059356,0.581298
759,28,21252,148868068,256059356,0.581381
760,15,11400,148879468,256059356,0.581426
761,11,8371,148887839,256059356,0.581458
762,19,14478,148902317,256059356,0.581515
763,15,11445,148913762,256059356,0.58156
764,8,6112,148919874,256059356,0.581583
765,19,14535,148934409,256059356,0.58164
766,18,13788,148948197,256059356,0.581694
767,17,13039,148961236,256059356,0.581745
768,16,12288,148973524,256059356,0.581793
769,8,6152,148979676,256059356,0.581817
770,14,10780,148990456,256059356,0.581859
771,18,13878,149004334,256059356,0.581913
772,22,16984,149021318,256059356,0.58198
773,28,21644,149042962,256059356,0.582064
774,12,9288,149052250,256059356,0.5821
775,22,17050,149069300,256059356,0.582167
776,10,7760,149077060,256059356,0.582197
777,20,15540,149092600,256059356,0.582258
778,16,12448,149105048,256059356,0.582307
779,14,10906,149115954,256059356,0.582349
780,14,10920,149126874,256059356,0.582392
781,17,13277,149140151,256059356,0.582444
782,16,12512,149152663,256059356,0.582493
783,14,10962,149163625,256059356,0.582535
784,14,10976,149174601,256059356,0.582578
785,15,11775,149186376,256059356,0.582624
786,15,11790,149198166,256059356,0.58267
787,14,11018,149209184,256059356,0.582713
788,14,11032,149220216,256059356,0.582756
789,9,7101,149227317,256059356,0.582784
790,19,15010,149242327,256059356,0.582843
791,12,9492,149251819,256059356,0.58288
792,14,11088,149262907,256059356,0.582923
793,24,19032,149281939,256059356,0.582997
794,12,9528,149291467,256059356,0.583035
795,14,11130,149302597,256059356,0.583078
796,9,7164,149309761,256059356,0.583106
797,18,14346,149324107,256059356,0.583162
798,15,11970,149336077,256059356,0.583209
799,16,12784,149348861,256059356,0.583259
800,15,12000,149360861,256059356,0.583306
801,23,18423,149379284,256059356,0.583378
802,20,16040,149395324,256059356,0.58344
803,19,15257,149410581,256059356,0.5835
804,15,12060,149422641,256059356,0.583547
805,19,15295,149437936,256059356,0.583607
806,9,7254,149445190,256059356,0.583635
807,13,10491,149455681,256059356,0.583676
808,14,11312,149466993,256059356,0.58372
809,21,16989,149483982,256059356,0.583786
810,17,13770,149497752,256059356,0.58384
811,12,9732,149507484,256059356,0.583878
812,9,7308,149514792,256059356,0.583907
813,13,10569,149525361,256059356,0.583948
814,14,11396,149536757,256059356,0.583993
815,16,13040,149549797,256059356,0.584043
816,14,11424,149561221,256059356,0.584088
817,11,8987,149570208,256059356,0.584123
818,11,8998,149579206,256059356,0.584158
819,19,15561,149594767,256059356,0.584219
820,20,16400,149611167,256059356,0.584283
821,14,11494,149622661,256059356,0.584328
822,16,13152,149635813,256059356,0.584379
823,11,9053,149644866,256059356,0.584415
824,12,9888,149654754,256059356,0.584453
825,12,9900,149664654,256059356,0.584492
826,12,9912,149674566,256059356,0.584531
827,21,17367,149691933,256059356,0.584599
828,10,8280,149700213,256059356,0.584631
829,14,11606,149711819,256059356,0.584676
830,9,7470,149719289,256059356,0.584705
831,21,17451,149736740,256059356,0.584774
832,14,11648,149748388,256059356,0.584819
833,13,10829,149759217,256059356,0.584861
834,7,5838,149765055,256059356,0.584884
835,14,11690,149776745,256059356,0.58493
836,7,5852,149782597,256059356,0.584953
837,15,12555,149795152,256059356,0.585002
838,15,12570,149807722,256059356,0.585051
839,9,7551,149815273,256059356,0.58508
840,11,9240,149824513,256059356,0.585116
841,12,10092,149834605,256059356,0.585156
842,18,15156,149849761,256059356,0.585215
843,9,7587,149857348,256059356,0.585245
844,16,13504,149870852,256059356,0.585297
845,10,8450,149879302,256059356,0.58533
846,10,8460,149887762,256059356,0.585363
847,10,8470,149896232,256059356,0.585396
848,9,7632,149903864,256059356,0.585426
849,17,14433,149918297,256059356,0.585483
850,23,19550,149937847,256059356,0.585559
851,13,11063,149948910,256059356,0.585602
852,15,12780,149961690,256059356,0.585652
853,11,9383,149971073,256059356,0.585689
854,12,10248,149981321,256059356,0.585729
855,19,16245,149997566,256059356,0.585792
856,6,5136,150002702,256059356,0.585812
857,16,13712,150016414,256059356,0.585866
858,16,13728,150030142,256059356,0.585919
859,14,12026,150042168,256059356,0.585966
860,20,17200,150059368,256059356,0.586034
861,19,16359,150075727,256059356,0.586097
862,22,18964,150094691,256059356,0.586171
863,15,12945,150107636,256059356,0.586222
864,22,19008,150126644,256059356,0.586296
865,15,12975,150139619,256059356,0.586347
866,14,12124,150151743,256059356,0.586394
867,21,18207,150169950,256059356,0.586465
868,15,13020,150182970,256059356,0.586516
869,11,9559,150192529,256059356,0.586554
870,10,8700,150201229,256059356,0.586588
871,10,8710,150209939,256059356,0.586622
872,10,8720,150218659,256059356,0.586656
873,10,8730,150227389,256059356,0.58669
874,10,8740,150236129,256059356,0.586724
875,10,8750,150244879,256059356,0.586758
876,8,7008,150251887,256059356,0.586785
877,14,12278,150264165,256059356,0.586833
878,12,10536,150274701,256059356,0.586874
879,10,8790,150283491,256059356,0.586909
880,11,9680,150293171,256059356,0.586947
881,9,7929,150301100,256059356,0.586978
882,14,12348,150313448,256059356,0.587026
883,15,13245,150326693,256059356,0.587078
884,6,5304,150331997,256059356,0.587098
885,18,15930,150347927,256059356,0.58716
886,17,15062,150362989,256059356,0.587219
887,11,9757,150372746,256059356,0.587257
888,10,8880,150381626,256059356,0.587292
889,19,16891,150398517,256059356,0.587358
890,12,10680,150409197,256059356,0.5874
891,14,12474,150421671,256059356,0.587448
892,12,10704,150432375,256059356,0.58749
893,12,10716,150443091,256059356,0.587532
894,6,5364,150448455,256059356,0.587553
895,15,13425,150461880,256059356,0.587605
896,11,9856,150471736,256059356,0.587644
897,16,14352,150486088,256059356,0.5877
898,14,12572,150498660,256059356,0.587749
899,9,8091,150506751,256059356,0.587781
900,16,14400,150521151,256059356,0.587837
901,13,11713,150532864,256059356,0.587883
902,14,12628,150545492,256059356,0.587932
903,11,9933,150555425,256059356,0.587971
904,15,13560,150568985,256059356,0.588024
905,17,15385,150584370,256059356,0.588084
906,13,11778,150596148,256059356,0.58813
907,18,16326,150612474,256059356,0.588194
908,13,11804,150624278,256059356,0.58824
909,12,10908,150635186,256059356,0.588282
910,6,5460,150640646,256059356,0.588304
911,14,12754,150653400,256059356,0.588353
912,10,9120,150662520,256059356,0.588389
913,10,9130,150671650,256059356,0.588425
914,5,4570,150676220,256059356,0.588443
915,10,9150,150685370,256059356,0.588478
916,17,15572,150700942,256059356,0.588539
917,15,13755,150714697,256059356,0.588593
918,18,16524,150731221,256059356,0.588657
919,12,11028,150742249,256059356,0.5887
920,10,9200,150751449,256059356,0.588736
921,11,10131,150761580,256059356,0.588776
922,18,16596,150778176,256059356,0.588841
923,10,9230,150787406,256059356,0.588877
924,7,6468,150793874,256059356,0.588902
925,13,12025,150805899,256059356,0.588949
926,8,7408,150813307,256059356,0.588978
927,8,7416,150820723,256059356,0.589007
928,17,15776,150836499,256059356,0.589068
929,8,7432,150843931,256059356,0.589098
930,9,8370,150852301,256059356,0.58913
931,12,11172,150863473,256059356,0.589174
932,6,5592,150869065,256059356,0.589196
933,12,11196,150880261,256059356,0.589239
934,11,10274,150890535,256059356,0.58928
935,9,8415,150898950,256059356,0.589312
936,8,7488,150906438,256059356,0.589342
937,6,5622,150912060,256059356,0.589364
938,9,8442,150920502,256059356,0.589397
939,8,7512,150928014,256059356,0.589426
940,5,4700,150932714,256059356,0.589444
941,9,8469,150941183,256059356,0.589477
942,10,9420,150950603,256059356,0.589514
943,7,6601,150957204,256059356,0.58954
944,7,6608,150963812,256059356,0.589566
945,13,12285,150976097,256059356,0.589614
946,12,11352,150987449,256059356,0.589658
947,12,11364,150998813,256059356,0.589702
948,20,18960,151017773,256059356,0.589776
949,12,11388,151029161,256059356,0.589821
950,11,10450,151039611,256059356,0.589862
951,5,4755,151044366,256059356,0.58988
952,13,12376,151056742,256059356,0.589929
953,12,11436,151068178,256059356,0.589973
954,8,7632,151075810,256059356,0.590003
955,14,13370,151089180,256059356,0.590055
956,14,13384,151102564,256059356,0.590108
957,12,11484,151114048,256059356,0.590152
958,10,9580,151123628,256059356,0.59019
959,10,9590,151133218,256059356,0.590227
960,14,13440,151146658,256059356,0.59028
961,10,9610,151156268,256059356,0.590317
962,10,9620,151165888,256059356,0.590355
963,16,15408,151181296,256059356,0.590415
964,12,11568,151192864,256059356,0.59046
965,13,12545,151205409,256059356,0.590509
966,11,10626,151216035,256059356,0.590551
967,13,12571,151228606,256059356,0.5906
968,12,11616,151240222,256059356,0.590645
969,11,10659,151250881,256059356,0.590687
970,13,12610,151263491,256059356,0.590736
971,13,12623,151276114,256059356,0.590785
972,10,9720,151285834,256059356,0.590823
973,6,5838,151291672,256059356,0.590846
974,11,10714,151302386,256059356,0.590888
975,6,5850,151308236,256059356,0.590911
976,12,11712,151319948,256059356,0.590957
977,11,10747,151330695,256059356,0.590998
978,9,8802,151339497,256059356,0.591033
979,6,5874,151345371,256059356,0.591056
980,11,10780,151356151,256059356,0.591098
981,10,9810,151365961,256059356,0.591136
982,10,9820,151375781,256059356,0.591175
983,10,9830,151385611,256059356,0.591213
984,7,6888,151392499,256059356,0.59124
985,13,12805,151405304,256059356,0.59129
986,9,8874,151414178,256059356,0.591325
987,8,7896,151422074,256059356,0.591355
988,8,7904,151429978,256059356,0.591386
989,6,5934,151435912,256059356,0.591409
990,10,9900,151445812,256059356,0.591448
991,3,2973,151448785,256059356,0.59146
992,13,12896,151461681,256059356,0.59151
993,16,15888,151477569,256059356,0.591572
994,1,994,151478563,256059356,0.591576
995,12,11940,151490503,256059356,0.591623
996,6,5976,151496479,256059356,0.591646
997,8,7976,151504455,256059356,0.591677
998,11,10978,151515433,256059356,0.59172
999,7,6993,151522426,256059356,0.591747
1000,9,9000,151531426,256059356,0.591782
1001,19,19019,151550445,256059356,0.591857
1002,16,16032,151566477,256059356,0.591919
1003,11,11033,151577510,256059356,0.591962
1004,22,22088,151599598,256059356,0.592049
1005,15,15075,151614673,256059356,0.592108
1006,4,4024,151618697,256059356,0.592123
1007,14,14098,151632795,256059356,0.592178
1008,7,7056,151639851,256059356,0.592206
1009,8,8072,151647923,256059356,0.592237
1010,10,10100,151658023,256059356,0.592277
1011,7,7077,151665100,256059356,0.592304
1012,14,14168,151679268,256059356,0.59236
1013,12,12156,151691424,256059356,0.592407
1014,11,11154,151702578,256059356,0.592451
1015,11,11165,151713743,256059356,0.592494
1016,12,12192,151725935,256059356,0.592542
1017,8,8136,151734071,256059356,0.592574
1018,13,13234,151747305,256059356,0.592626
1019,9,9171,151756476,256059356,0.592661
1020,10,10200,151766676,256059356,0.592701
1021,12,12252,151778928,256059356,0.592749
1022,10,10220,151789148,256059356,0.592789
1023,10,10230,151799378,256059356,0.592829
1024,10,10240,151809618,256059356,0.592869
1025,7,7175,151816793,256059356,0.592897
1026,6,6156,151822949,256059356,0.592921
1027,7,7189,151830138,256059356,0.592949
1028,7,7196,151837334,256059356,0.592977
1029,9,9261,151846595,256059356,0.593013
1030,10,10300,151856895,256059356,0.593053
1031,13,13403,151870298,256059356,0.593106
1032,9,9288,151879586,256059356,0.593142
1033,5,5165,151884751,256059356,0.593162
1034,4,4136,151888887,256059356,0.593178
1035,8,8280,151897167,256059356,0.593211
1036,5,5180,151902347,256059356,0.593231
1037,12,12444,151914791,256059356,0.59328
1038,6,6228,151921019,256059356,0.593304
1039,7,7273,151928292,256059356,0.593332
1040,6,6240,151934532,256059356,0.593357
1041,9,9369,151943901,256059356,0.593393
1042,15,15630,151959531,256059356,0.593454
1043,7,7301,151966832,256059356,0.593483
1044,13,13572,151980404,256059356,0.593536
1045,4,4180,151984584,256059356,0.593552
1046,13,13598,151998182,256059356,0.593605
1047,8,8376,152006558,256059356,0.593638
1048,9,9432,152015990,256059356,0.593675
1049,12,12588,152028578,256059356,0.593724
1050,15,15750,152044328,256059356,0.593785
1051,10,10510,152054838,256059356,0.593827
1052,6,6312,152061150,256059356,0.593851
1053,12,12636,152073786,256059356,0.593901
1054,10,10540,152084326,256059356,0.593942
1055,11,11605,152095931,256059356,0.593987
1056,7,7392,152103323,256059356,0.594016
1057,8,8456,152111779,256059356,0.594049
1058,8,8464,152120243,256059356,0.594082
1059,14,14826,152135069,256059356,0.59414
1060,13,13780,152148849,256059356,0.594194
1061,7,7427,152156276,256059356,0.594223
1062,9,9558,152165834,256059356,0.59426
1063,13,13819,152179653,256059356,0.594314
1064,9,9576,152189229,256059356,0.594351
1065,12,12780,152202009,256059356,0.594401
1066,12,12792,152214801,256059356,0.594451
1067,7,7469,152222270,256059356,0.59448
1068,14,14952,152237222,256059356,0.594539
1069,6,6414,152243636,256059356,0.594564
1070,8,8560,152252196,256059356,0.594597
1071,8,8568,152260764,256059356,0.594631
1072,7,7504,152268268,256059356,0.59466
1073,7,7511,152275779,256059356,0.594689
1074,11,11814,152287593,256059356,0.594736
1075,12,12900,152300493,256059356,0.594786
1076,9,9684,152310177,256059356,0.594824
1077,11,11847,152322024,256059356,0.59487
1078,9,9702,152331726,256059356,0.594908
1079,11,11869,152343595,256059356,0.594954
1080,10,10800,152354395,256059356,0.594996
1081,15,16215,152370610,256059356,0.59506
1082,11,11902,152382512,256059356,0.595106
1083,15,16245,152398757,256059356,0.59517
1084,11,11924,152410681,256059356,0.595216
1085,11,11935,152422616,256059356,0.595263
1086,7,7602,152430218,256059356,0.595293
1087,8,8696,152438914,256059356,0.595326
1088,14,15232,152454146,256059356,0.595386
1089,15,16335,152470481,256059356,0.59545
1090,13,14170,152484651,256059356,0.595505
1091,10,10910,152495561,256059356,0.595548
1092,9,9828,152505389,256059356,0.595586
1093,8,8744,152514133,256059356,0.59562
1094,8,8752,152522885,256059356,0.595654
1095,13,14235,152537120,256059356,0.59571
1096,11,12056,152549176,256059356,0.595757
1097,10,10970,152560146,256059356,0.5958
1098,10,10980,152571126,256059356,0.595843
1099,12,13188,152584314,256059356,0.595894
1100,12,13200,152597514,256059356,0.595946
1101,14,15414,152612928,256059356,0.596006
1102,10,11020,152623948,256059356,0.596049
1103,16,17648,152641596,256059356,0.596118
1104,12,13248,152654844,256059356,0.59617
1105,10,11050,152665894,256059356,0.596213
1106,11,12166,152678060,256059356,0.59626
1107,12,13284,152691344,256059356,0.596312
1108,10,11080,152702424,256059356,0.596356
1109,12,13308,152715732,256059356,0.596408
1110,7,7770,152723502,256059356,0.596438
1111,10,11110,152734612,256059356,0.596481
1112,8,8896,152743508,256059356,0.596516
1113,13,14469,152757977,256059356,0.596573
1114,10,11140,152769117,256059356,0.596616
1115,9,10035,152779152,256059356,0.596655
1116,9,10044,152789196,256059356,0.596694
1117,13,14521,152803717,256059356,0.596751
1118,10,11180,152814897,256059356,0.596795
1119,8,8952,152823849,256059356,0.59683
1120,14,15680,152839529,256059356,0.596891
1121,10,11210,152850739,256059356,0.596935
1122,10,11220,152861959,256059356,0.596979
1123,9,10107,152872066,256059356,0.597018
1124,21,23604,152895670,256059356,0.59711
1125,10,11250,152906920,256059356,0.597154
1126,8,9008,152915928,256059356,0.597189
1127,7,7889,152923817,256059356,0.59722
1128,8,9024,152932841,256059356,0.597255
1129,4,4516,152937357,256059356,0.597273
1130,14,15820,152953177,256059356,0.597335
1131,3,3393,152956570,256059356,0.597348
1132,4,4528,152961098,256059356,0.597366
1133,13,14729,152975827,256059356,0.597423
1134,8,9072,152984899,256059356,0.597459
1135,10,11350,152996249,256059356,0.597503
1136,6,6816,153003065,256059356,0.59753
1137,10,11370,153014435,256059356,0.597574
1138,9,10242,153024677,256059356,0.597614
1139,7,7973,153032650,256059356,0.597645
1140,13,14820,153047470,256059356,0.597703
1141,11,12551,153060021,256059356,0.597752
1142,9,10278,153070299,256059356,0.597792
1143,9,10287,153080586,256059356,0.597832
1144,13,14872,153095458,256059356,0.597891
1145,11,12595,153108053,256059356,0.59794
1146,6,6876,153114929,256059356,0.597967
1147,5,5735,153120664,256059356,0.597989
1148,4,4592,153125256,256059356,0.598007
1149,8,9192,153134448,256059356,0.598043
1150,11,12650,153147098,256059356,0.598092
1151,14,16114,153163212,256059356,0.598155
1152,6,6912,153170124,256059356,0.598182
1153,11,12683,153182807,256059356,0.598232
1154,5,5770,153188577,256059356,0.598254
1155,7,8085,153196662,256059356,0.598286
1156,8,9248,153205910,256059356,0.598322
1157,6,6942,153212852,256059356,0.598349
1158,10,11580,153224432,256059356,0.598394
1159,8,9272,153233704,256059356,0.59843
1160,6,6960,153240664,256059356,0.598458
1161,7,8127,153248791,256059356,0.598489
1162,14,16268,153265059,256059356,0.598553
1163,10,11630,153276689,256059356,0.598598
1164,8,9312,153286001,256059356,0.598635
1165,15,17475,153303476,256059356,0.598703
1166,7,8162,153311638,256059356,0.598735
1167,3,3501,153315139,256059356,0.598748
1168,9,10512,153325651,256059356,0.598789
1169,8,9352,153335003,256059356,0.598826
1170,9,10530,153345533,256059356,0.598867
1171,3,3513,153349046,256059356,0.598881
1172,5,5860,153354906,256059356,0.598904
1173,12,14076,153368982,256059356,0.598959
1174,6,7044,153376026,256059356,0.598986
1175,14,16450,153392476,256059356,0.59905
1176,12,14112,153406588,256059356,0.599106
1177,10,11770,153418358,256059356,0.599152
1178,11,12958,153431316,256059356,0.599202
1179,9,10611,153441927,256059356,0.599244
1180,9,10620,153452547,256059356,0.599285
1181,6,7086,153459633,256059356,0.599313
1182,11,13002,153472635,256059356,0.599364
1183,8,9464,153482099,256059356,0.5994
1184,11,13024,153495123,256059356,0.599451
1185,9,10665,153505788,256059356,0.599493
1186,11,13046,153518834,256059356,0.599544
1187,12,14244,153533078,256059356,0.5996
1188,7,8316,153541394,256059356,0.599632
1189,10,11890,153553284,256059356,0.599678
1190,5,5950,153559234,256059356,0.599702
1191,8,9528,153568762,256059356,0.599739
1192,8,9536,153578298,256059356,0.599776
1193,7,8351,153586649,256059356,0.599809
1194,15,17910,153604559,256059356,0.599879
1195,23,27485,153632044,256059356,0.599986
1196,11,13156,153645200,256059356,0.600037
1197,8,9576,153654776,256059356,0.600075
1198,7,8386,153663162,256059356,0.600108
1199,7,8393,153671555,256059356,0.60014
1200,5,6000,153677555,256059356,0.600164
1201,14,16814,153694369,256059356,0.600229
1202,7,8414,153702783,256059356,0.600262
1203,12,14436,153717219,256059356,0.600319
1204,6,7224,153724443,256059356,0.600347
1205,6,7230,153731673,256059356,0.600375
1206,10,12060,153743733,256059356,0.600422
1207,7,8449,153752182,256059356,0.600455
1208,5,6040,153758222,256059356,0.600479
1209,12,14508,153772730,256059356,0.600535
1210,7,8470,153781200,256059356,0.600569
1211,8,9688,153790888,256059356,0.600606
1212,3,3636,153794524,256059356,0.600621
1213,8,9704,153804228,256059356,0.600658
1214,11,13354,153817582,256059356,0.600711
1215,11,13365,153830947,256059356,0.600763
1216,5,6080,153837027,256059356,0.600787
1217,9,10953,153847980,256059356,0.600829
1218,6,7308,153855288,256059356,0.600858
1219,7,8533,153863821,256059356,0.600891
1220,10,12200,153876021,256059356,0.600939
1221,6,7326,153883347,256059356,0.600967
1222,5,6110,153889457,256059356,0.600991
1223,10,12230,153901687,256059356,0.601039
1224,5,6120,153907807,256059356,0.601063
1225,7,8575,153916382,256059356,0.601096
1226,7,8582,153924964,256059356,0.60113
1227,9,11043,153936007,256059356,0.601173
1228,7,8596,153944603,256059356,0.601207
1229,10,12290,153956893,256059356,0.601255
1230,5,6150,153963043,256059356,0.601279
1231,9,11079,153974122,256059356,0.601322
1232,13,16016,153990138,256059356,0.601385
1233,11,13563,154003701,256059356,0.601438
1234,5,6170,154009871,256059356,0.601462
1235,15,18525,154028396,256059356,0.601534
1236,5,6180,154034576,256059356,0.601558
1237,6,7422,154041998,256059356,0.601587
1238,5,6190,154048188,256059356,0.601611
1239,9,11151,154059339,256059356,0.601655
1240,2,2480,154061819,256059356,0.601664
1241,7,8687,154070506,256059356,0.601698
1242,10,12420,154082926,256059356,0.601747
1243,5,6215,154089141,256059356,0.601771
1244,7,8708,154097849,256059356,0.601805
1245,6,7470,154105319,256059356,0.601834
1246,11,13706,154119025,256059356,0.601888
1247,9,11223,154130248,256059356,0.601932
1248,5,6240,154136488,256059356,0.601956
1249,7,8743,154145231,256059356,0.60199
1250,10,12500,154157731,256059356,0.602039
1251,4,5004,154162735,256059356,0.602059
1252,9,11268,154174003,256059356,0.602103
1253,17,21301,154195304,256059356,0.602186
1254,12,15048,154210352,256059356,0.602245
1255,4,5020,154215372,256059356,0.602264
1256,8,10048,154225420,256059356,0.602303
1257,4,5028,154230448,256059356,0.602323
1258,9,11322,154241770,256059356,0.602367
1259,11,13849,154255619,256059356,0.602421
1260,6,7560,154263179,256059356,0.602451
1261,9,11349,154274528,256059356,0.602495
1262,14,17668,154292196,256059356,0.602564
1263,6,7578,154299774,256059356,0.602594
1264,10,12640,154312414,256059356,0.602643
1265,8,10120,154322534,256059356,0.602683
1266,6,7596,154330130,256059356,0.602712
1267,7,8869,154338999,256059356,0.602747
1268,8,10144,154349143,256059356,0.602787
1269,12,15228,154364371,256059356,0.602846
1270,4,5080,154369451,256059356,0.602866
1271,2,2542,154371993,256059356,0.602876
1272,7,8904,154380897,256059356,0.602911
1273,11,14003,154394900,256059356,0.602965
1274,12,15288,154410188,256059356,0.603025
1275,5,6375,154416563,256059356,0.60305
1276,8,10208,154426771,256059356,0.60309
1277,12,15324,154442095,256059356,0.60315
1278,12,15336,154457431,256059356,0.603209
1279,8,10232,154467663,256059356,0.603249
1280,15,19200,154486863,256059356,0.603324
1281,8,10248,154497111,256059356,0.603364
1282,3,3846,154500957,256059356,0.603379
1283,7,8981,154509938,256059356,0.603415
1284,6,7704,154517642,256059356,0.603445
1285,2,2570,154520212,256059356,0.603455
1286,11,14146,154534358,256059356,0.60351
1287,7,9009,154543367,256059356,0.603545
1288,4,5152,154548519,256059356,0.603565
1289,9,11601,154560120,256059356,0.603611
1290,1,1290,154561410,256059356,0.603616
1291,10,12910,154574320,256059356,0.603666
1292,5,6460,154580780,256059356,0.603691
1293,9,11637,154592417,256059356,0.603737
1294,7,9058,154601475,256059356,0.603772
1295,7,9065,154610540,256059356,0.603807
1296,8,10368,154620908,256059356,0.603848
1297,5,6485,154627393,256059356,0.603873
1298,9,11682,154639075,256059356,0.603919
1299,10,12990,154652065,256059356,0.60397
1300,13,16900,154668965,256059356,0.604036
1301,5,6505,154675470,256059356,0.604061
1302,7,9114,154684584,256059356,0.604097
1303,10,13030,154697614,256059356,0.604147
1304,3,3912,154701526,256059356,0.604163
1305,3,3915,154705441,256059356,0.604178
1306,6,7836,154713277,256059356,0.604209
1307,7,9149,154722426,256059356,0.604244
1308,7,9156,154731582,256059356,0.60428
1309,9,11781,154743363,256059356,0.604326
1310,17,22270,154765633,256059356,0.604413
1311,5,6555,154772188,256059356,0.604439
1312,3,3936,154776124,256059356,0.604454
1313,6,7878,154784002,256059356,0.604485
1314,7,9198,154793200,256059356,0.604521
1315,7,9205,154802405,256059356,0.604557
1316,9,11844,154814249,256059356,0.604603
1317,11,14487,154828736,256059356,0.60466
1318,4,5272,154834008,256059356,0.60468
1319,6,7914,154841922,256059356,0.604711
1320,6,7920,154849842,256059356,0.604742
1321,8,10568,154860410,256059356,0.604783
1322,8,10576,154870986,256059356,0.604825
1323,8,10584,154881570,256059356,0.604866
1324,8,10592,154892162,256059356,0.604907
1325,6,7950,154900112,256059356,0.604938
1326,4,5304,154905416,256059356,0.604959
1327,4,5308,154910724,256059356,0.60498
1328,11,14608,154925332,256059356,0.605037
1329,11,14619,154939951,256059356,0.605094
1330,8,10640,154950591,256059356,0.605135
1331,5,6655,154957246,256059356,0.605161
1332,8,10656,154967902,256059356,0.605203
1333,12,15996,154983898,256059356,0.605266
1334,7,9338,154993236,256059356,0.605302
1335,6,8010,155001246,256059356,0.605333
1336,7,9352,155010598,256059356,0.60537
1337,5,6685,155017283,256059356,0.605396
1338,4,5352,155022635,256059356,0.605417
1339,1,1339,155023974,256059356,0.605422
1340,2,2680,155026654,256059356,0.605432
1341,9,12069,155038723,256059356,0.60548
1342,3,4026,155042749,256059356,0.605495
1343,5,6715,155049464,256059356,0.605522
1344,13,17472,155066936,256059356,0.60559
1345,7,9415,155076351,256059356,0.605627
1346,5,6730,155083081,256059356,0.605653
1347,4,5388,155088469,256059356,0.605674
1348,8,10784,155099253,256059356,0.605716
1349,20,26980,155126233,256059356,0.605821
1350,23,31050,155157283,256059356,0.605943
1351,5,6755,155164038,256059356,0.605969
1352,7,9464,155173502,256059356,0.606006
1353,8,10824,155184326,256059356,0.606048
1354,9,12186,155196512,256059356,0.606096
1355,2,2710,155199222,256059356,0.606106
1356,5,6780,155206002,256059356,0.606133
1357,6,8142,155214144,256059356,0.606165
1358,7,9506,155223650,256059356,0.606202
1359,5,6795,155230445,256059356,0.606228
1360,11,14960,155245405,256059356,0.606287
1361,5,6805,155252210,256059356,0.606313
1362,5,6810,155259020,256059356,0.60634
1363,5,6815,155265835,256059356,0.606367
1364,9,12276,155278111,256059356,0.606415
1365,8,10920,155289031,256059356,0.606457
1366,5,6830,155295861,256059356,0.606484
1367,8,10936,155306797,256059356,0.606527
1368,5,6840,155313637,256059356,0.606553
1369,10,13690,155327327,256059356,0.606607
1370,7,9590,155336917,256059356,0.606644
1371,15,20565,155357482,256059356,0.606724
1372,8,10976,155368458,256059356,0.606767
1373,7,9611,155378069,256059356,0.606805
1374,5,6870,155384939,256059356,0.606832
1375,7,9625,155394564,256059356,0.606869
1376,5,6880,155401444,256059356,0.606896
1377,4,5508,155406952,256059356,0.606918
1378,9,12402,155419354,256059356,0.606966
1379,5,6895,155426249,256059356,0.606993
1380,6,8280,155434529,256059356,0.607025
1381,3,4143,155438672,256059356,0.607042
1382,2,2764,155441436,256059356,0.607052
1383,4,5532,155446968,256059356,0.607074
1384,10,13840,155460808,256059356,0.607128
1385,8,11080,155471888,256059356,0.607171
1386,2,2772,155474660,256059356,0.607182
1387,4,5548,155480208,256059356,0.607204
1388,6,8328,155488536,256059356,0.607236
1389,8,11112,155499648,256059356,0.60728
1390,16,22240,155521888,256059356,0.607367
1391,9,12519,155534407,256059356,0.607415
1392,6,8352,155542759,256059356,0.607448
1393,7,9751,155552510,256059356,0.607486
1394,4,5576,155558086,256059356,0.607508
1395,5,6975,155565061,256059356,0.607535
1396,9,12564,155577625,256059356,0.607584
1397,7,9779,155587404,256059356,0.607622
1398,5,6990,155594394,256059356,0.60765
1399,5,6995,155601389,256059356,0.607677
1400,5,7000,155608389,256059356,0.607704
1401,4,5604,155613993,256059356,0.607726
1402,6,8412,155622405,256059356,0.607759
1403,7,9821,155632226,256059356,0.607797
1404,8,11232,155643458,256059356,0.607841
1405,6,8430,155651888,256059356,0.607874
1406,6,8436,155660324,256059356,0.607907
1407,3,4221,155664545,256059356,0.607924
1408,2,2816,155667361,256059356,0.607935
1409,10,14090,155681451,256059356,0.60799
1410,4,5640,155687091,256059356,0.608012
1411,5,7055,155694146,256059356,0.608039
1412,2,2824,155696970,256059356,0.60805
1413,4,5652,155702622,256059356,0.608072
1414,6,8484,155711106,256059356,0.608106
1415,4,5660,155716766,256059356,0.608128
1416,5,7080,155723846,256059356,0.608155
1417,2,2834,155726680,256059356,0.608166
1418,4,5672,155732352,256059356,0.608188
1419,1,1419,155733771,256059356,0.608194
1420,9,12780,155746551,256059356,0.608244
1421,7,9947,155756498,256059356,0.608283
1422,4,5688,155762186,256059356,0.608305
1423,7,9961,155772147,256059356,0.608344
1424,11,15664,155787811,256059356,0.608405
1425,5,7125,155794936,256059356,0.608433
1426,6,8556,155803492,256059356,0.608466
1427,7,9989,155813481,256059356,0.608505
1428,4,5712,155819193,256059356,0.608528
1429,2,2858,155822051,256059356,0.608539
1430,4,5720,155827771,256059356,0.608561
1431,4,5724,155833495,256059356,0.608583
1432,10,14320,155847815,256059356,0.608639
1433,2,2866,155850681,256059356,0.608651
1434,10,14340,155865021,256059356,0.608707
1435,5,7175,155872196,256059356,0.608735
1436,2,2872,155875068,256059356,0.608746
1437,7,10059,155885127,256059356,0.608785
1438,8,11504,155896631,256059356,0.60883
1439,7,10073,155906704,256059356,0.608869
1440,4,5760,155912464,256059356,0.608892
1441,4,5764,155918228,256059356,0.608914
1442,6,8652,155926880,256059356,0.608948
1443,4,5772,155932652,256059356,0.608971
1444,6,8664,155941316,256059356,0.609005
1445,6,8670,155949986,256059356,0.609038
1446,10,14460,155964446,256059356,0.609095
1447,6,8682,155973128,256059356,0.609129
1448,3,4344,155977472,256059356,0.609146
1449,5,7245,155984717,256059356,0.609174
1451,10,14510,155999227,256059356,0.609231
1452,4,5808,156005035,256059356,0.609253
1453,8,11624,156016659,256059356,0.609299
1454,6,8724,156025383,256059356,0.609333
1455,7,10185,156035568,256059356,0.609373
1456,3,4368,156039936,256059356,0.60939
1457,6,8742,156048678,256059356,0.609424
1458,4,5832,156054510,256059356,0.609447
1459,3,4377,156058887,256059356,0.609464
1460,5,7300,156066187,256059356,0.609492
1461,3,4383,156070570,256059356,0.609509
1462,3,4386,156074956,256059356,0.609526
1463,2,2926,156077882,256059356,0.609538
1464,7,10248,156088130,256059356,0.609578
1465,5,7325,156095455,256059356,0.609607
1466,5,7330,156102785,256059356,0.609635
1467,8,11736,156114521,256059356,0.609681
1468,26,38168,156152689,256059356,0.60983
1469,52,76388,156229077,256059356,0.610128
1470,3,4410,156233487,256059356,0.610146
1471,4,5884,156239371,256059356,0.610169
1472,5,7360,156246731,256059356,0.610197
1473,5,7365,156254096,256059356,0.610226
1474,5,7370,156261466,256059356,0.610255
1475,1,1475,156262941,256059356,0.610261
1476,4,5904,156268845,256059356,0.610284
1477,5,7385,156276230,256059356,0.610313
1478,4,5912,156282142,256059356,0.610336
1479,5,7395,156289537,256059356,0.610364
1480,2,2960,156292497,256059356,0.610376
1481,5,7405,156299902,256059356,0.610405
1482,4,5928,156305830,256059356,0.610428
1483,5,7415,156313245,256059356,0.610457
1484,6,8904,156322149,256059356,0.610492
1485,3,4455,156326604,256059356,0.610509
1486,3,4458,156331062,256059356,0.610527
1487,5,7435,156338497,256059356,0.610556
1488,7,10416,156348913,256059356,0.610596
1489,2,2978,156351891,256059356,0.610608
1490,6,8940,156360831,256059356,0.610643
1491,3,4473,156365304,256059356,0.61066
1492,2,2984,156368288,256059356,0.610672
1493,3,4479,156372767,256059356,0.61069
1494,2,2988,156375755,256059356,0.610701
1495,4,5980,156381735,256059356,0.610725
1496,3,4488,156386223,256059356,0.610742
1497,2,2994,156389217,256059356,0.610754
1498,6,8988,156398205,256059356,0.610789
1499,3,4497,156402702,256059356,0.610806
1500,4,6000,156408702,256059356,0.61083
1501,2,3002,156411704,256059356,0.610842
1502,6,9012,156420716,256059356,0.610877
1503,3,4509,156425225,256059356,0.610894
1504,6,9024,156434249,256059356,0.61093
1505,6,9030,156443279,256059356,0.610965
1506,2,3012,156446291,256059356,0.610977
1507,5,7535,156453826,256059356,0.611006
1508,5,7540,156461366,256059356,0.611036
1509,5,7545,156468911,256059356,0.611065
1510,1,1510,156470421,256059356,0.611071
1511,2,3022,156473443,256059356,0.611083
1512,8,12096,156485539,256059356,0.61113
1513,4,6052,156491591,256059356,0.611154
1514,2,3028,156494619,256059356,0.611165
1515,6,9090,156503709,256059356,0.611201
1516,5,7580,156511289,256059356,0.611231
1517,5,7585,156518874,256059356,0.61126
1518,2,3036,156521910,256059356,0.611272
1519,1,1519,156523429,256059356,0.611278
1520,8,12160,156535589,256059356,0.611325
1521,4,6084,156541673,256059356,0.611349
1522,5,7610,156549283,256059356,0.611379
1523,8,12184,156561467,256059356,0.611426
1524,7,10668,156572135,256059356,0.611468
1525,5,7625,156579760,256059356,0.611498
1526,1,1526,156581286,256059356,0.611504
1527,7,10689,156591975,256059356,0.611546
1528,3,4584,156596559,256059356,0.611564
1529,4,6116,156602675,256059356,0.611587
1530,6,9180,156611855,256059356,0.611623
1531,3,4593,156616448,256059356,0.611641
1533,4,6132,156622580,256059356,0.611665
1534,4,6136,156628716,256059356,0.611689
1535,3,4605,156633321,256059356,0.611707
1536,4,6144,156639465,256059356,0.611731
1537,3,4611,156644076,256059356,0.611749
1538,5,7690,156651766,256059356,0.611779
1539,3,4617,156656383,256059356,0.611797
1540,5,7700,156664083,256059356,0.611827
1541,2,3082,156667165,256059356,0.611839
1543,2,3086,156670251,256059356,0.611851
1544,1,1544,156671795,256059356,0.611857
1545,4,6180,156677975,256059356,0.611881
1546,4,6184,156684159,256059356,0.611906
1547,3,4641,156688800,256059356,0.611924
1548,2,3096,156691896,256059356,0.611936
1549,2,3098,156694994,256059356,0.611948
1550,2,3100,156698094,256059356,0.61196
1551,2,3102,156701196,256059356,0.611972
1552,2,3104,156704300,256059356,0.611984
1553,4,6212,156710512,256059356,0.612009
1554,5,7770,156718282,256059356,0.612039
1555,2,3110,156721392,256059356,0.612051
1556,3,4668,156726060,256059356,0.612069
1557,3,4671,156730731,256059356,0.612087
1558,3,4674,156735405,256059356,0.612106
1559,4,6236,156741641,256059356,0.61213
1560,4,6240,156747881,256059356,0.612154
1561,3,4683,156752564,256059356,0.612173
1562,8,12496,156765060,256059356,0.612222
1563,2,3126,156768186,256059356,0.612234
1564,6,9384,156777570,256059356,0.61227
1565,2,3130,156780700,256059356,0.612283
1566,2,3132,156783832,256059356,0.612295
1567,6,9402,156793234,256059356,0.612332
1568,4,6272,156799506,256059356,0.612356
1569,3,4707,156804213,256059356,0.612374
1570,3,4710,156808923,256059356,0.612393
1571,6,9426,156818349,256059356,0.61243
1572,1,1572,156819921,256059356,0.612436
1573,2,3146,156823067,256059356,0.612448
1574,4,6296,156829363,256059356,0.612473
1575,6,9450,156838813,256059356,0.61251
1576,4,6304,156845117,256059356,0.612534
1577,4,6308,156851425,256059356,0.612559
1578,2,3156,156854581,256059356,0.612571
1579,1,1579,156856160,256059356,0.612577
1580,3,4740,156860900,256059356,0.612596
1581,4,6324,156867224,256059356,0.612621
1582,8,12656,156879880,256059356,0.61267
1583,6,9498,156889378,256059356,0.612707
1584,4,6336,156895714,256059356,0.612732
1586,2,3172,156898886,256059356,0.612744
1587,1,1587,156900473,256059356,0.61275
1588,6,9528,156910001,256059356,0.612788
1589,2,3178,156913179,256059356,0.6128
1590,5,7950,156921129,256059356,0.612831
1591,3,4773,156925902,256059356,0.61285
1592,3,4776,156930678,256059356,0.612868
1593,5,7965,156938643,256059356,0.612899
1594,2,3188,156941831,256059356,0.612912
1595,3,4785,156946616,256059356,0.612931
1596,5,7980,156954596,256059356,0.612962
1597,7,11179,156965775,256059356,0.613005
1598,4,6392,156972167,256059356,0.61303
1599,4,6396,156978563,256059356,0.613055
1600,3,4800,156983363,256059356,0.613074
1601,2,3202,156986565,256059356,0.613087
1602,6,9612,156996177,256059356,0.613124
1603,2,3206,156999383,256059356,0.613137
1604,5,8020,157007403,256059356,0.613168
1605,2,3210,157010613,256059356,0.613181
1606,1,1606,157012219,256059356,0.613187
1608,2,3216,157015435,256059356,0.613199
1609,3,4827,157020262,256059356,0.613218
1610,5,8050,157028312,256059356,0.61325
1611,6,9666,157037978,256059356,0.613287
1612,3,4836,157042814,256059356,0.613306
1613,2,3226,157046040,256059356,0.613319
1614,2,3228,157049268,256059356,0.613331
1615,3,4845,157054113,256059356,0.61335
1616,2,3232,157057345,256059356,0.613363
1617,3,4851,157062196,256059356,0.613382
1618,5,8090,157070286,256059356,0.613414
1619,4,6476,157076762,256059356,0.613439
1620,1,1620,157078382,256059356,0.613445
1621,2,3242,157081624,256059356,0.613458
1622,6,9732,157091356,256059356,0.613496
1623,3,4869,157096225,256059356,0.613515
1624,4,6496,157102721,256059356,0.61354
1625,5,8125,157110846,256059356,0.613572
1626,7,11382,157122228,256059356,0.613616
1627,2,3254,157125482,256059356,0.613629
1628,2,3256,157128738,256059356,0.613642
1629,2,3258,157131996,256059356,0.613655
1630,5,8150,157140146,256059356,0.613686
1631,2,3262,157143408,256059356,0.613699
1632,7,11424,157154832,256059356,0.613744
1633,3,4899,157159731,256059356,0.613763
1634,2,3268,157162999,256059356,0.613776
1635,1,1635,157164634,256059356,0.613782
1636,3,4908,157169542,256059356,0.613801
1637,4,6548,157176090,256059356,0.613827
1638,3,4914,157181004,256059356,0.613846
1639,3,4917,157185921,256059356,0.613865
1640,5,8200,157194121,256059356,0.613897
1641,6,9846,157203967,256059356,0.613936
1642,1,1642,157205609,256059356,0.613942
1643,3,4929,157210538,256059356,0.613961
1644,3,4932,157215470,256059356,0.613981
1645,3,4935,157220405,256059356,0.614
1647,3,4941,157225346,256059356,0.614019
1648,3,4944,157230290,256059356,0.614038
1649,4,6596,157236886,256059356,0.614064
1650,5,8250,157245136,256059356,0.614096
1651,3,4953,157250089,256059356,0.614116
1652,6,9912,157260001,256059356,0.614154
1653,1,1653,157261654,256059356,0.614161
1654,3,4962,157266616,256059356,0.61418
1655,4,6620,157273236,256059356,0.614206
1657,3,4971,157278207,256059356,0.614226
1658,5,8290,157286497,256059356,0.614258
1659,2,3318,157289815,256059356,0.614271
1660,2,3320,157293135,256059356,0.614284
1661,5,8305,157301440,256059356,0.614316
1662,3,4986,157306426,256059356,0.614336
1663,1,1663,157308089,256059356,0.614342
1664,1,1664,157309753,256059356,0.614349
1665,6,9990,157319743,256059356,0.614388
1666,3,4998,157324741,256059356,0.614407
1667,3,5001,157329742,256059356,0.614427
1668,2,3336,157333078,256059356,0.61444
1669,4,6676,157339754,256059356,0.614466
1670,3,5010,157344764,256059356,0.614486
1671,3,5013,157349777,256059356,0.614505
1672,6,10032,157359809,256059356,0.614544
1673,5,8365,157368174,256059356,0.614577
1674,3,5022,157373196,256059356,0.614597
1675,1,1675,157374871,256059356,0.614603
1676,4,6704,157381575,256059356,0.614629
1677,3,5031,157386606,256059356,0.614649
1678,2,3356,157389962,256059356,0.614662
1679,5,8395,157398357,256059356,0.614695
1680,1,1680,157400037,256059356,0.614701
1681,3,5043,157405080,256059356,0.614721
1682,1,1682,157406762,256059356,0.614728
1683,2,3366,157410128,256059356,0.614741
1684,6,10104,157420232,256059356,0.61478
1685,2,3370,157423602,256059356,0.614793
1686,4,6744,157430346,256059356,0.61482
1687,2,3374,157433720,256059356,0.614833
1688,1,1688,157435408,256059356,0.61484
1689,6,10134,157445542,256059356,0.614879
1690,2,3380,157448922,256059356,0.614892
1691,1,1691,157450613,256059356,0.614899
1692,2,3384,157453997,256059356,0.614912
1693,2,3386,157457383,256059356,0.614925
1695,1,1695,157459078,256059356,0.614932
1696,3,5088,157464166,256059356,0.614952
1697,3,5091,157469257,256059356,0.614972
1698,3,5094,157474351,256059356,0.614992
1699,5,8495,157482846,256059356,0.615025
1700,2,3400,157486246,256059356,0.615038
1701,6,10206,157496452,256059356,0.615078
1702,2,3404,157499856,256059356,0.615091
1703,2,3406,157503262,256059356,0.615104
1704,3,5112,157508374,256059356,0.615124
1705,4,6820,157515194,256059356,0.615151
1706,6,10236,157525430,256059356,0.615191
1707,2,3414,157528844,256059356,0.615204
1708,3,5124,157533968,256059356,0.615224
1709,6,10254,157544222,256059356,0.615264
1710,2,3420,157547642,256059356,0.615278
1711,8,13688,157561330,256059356,0.615331
1712,3,5136,157566466,256059356,0.615351
1713,5,8565,157575031,256059356,0.615385
1714,1,1714,157576745,256059356,0.615391
1715,3,5145,157581890,256059356,0.615412
1716,2,3432,157585322,256059356,0.615425
1717,4,6868,157592190,256059356,0.615452
1719,2,3438,157595628,256059356,0.615465
1720,2,3440,157599068,256059356,0.615479
1721,3,5163,157604231,256059356,0.615499
1722,3,5166,157609397,256059356,0.615519
1723,5,8615,157618012,256059356,0.615553
1724,5,8620,157626632,256059356,0.615586
1725,1,1725,157628357,256059356,0.615593
1726,2,3452,157631809,256059356,0.615607
1728,4,6912,157638721,256059356,0.615634
1729,4,6916,157645637,256059356,0.615661
1730,3,5190,157650827,256059356,0.615681
1731,3,5193,157656020,256059356,0.615701
1732,3,5196,157661216,256059356,0.615721
1733,3,5199,157666415,256059356,0.615742
1734,1,1734,157668149,256059356,0.615748
1735,2,3470,157671619,256059356,0.615762
1736,1,1736,157673355,256059356,0.615769
1737,6,10422,157683777,256059356,0.615809
1738,4,6952,157690729,256059356,0.615837
1739,2,3478,157694207,256059356,0.61585
1740,5,8700,157702907,256059356,0.615884
1741,1,1741,157704648,256059356,0.615891
1742,2,3484,157708132,256059356,0.615905
1743,1,1743,157709875,256059356,0.615911
1744,4,6976,157716851,256059356,0.615939
1745,2,3490,157720341,256059356,0.615952
1746,1,1746,157722087,256059356,0.615959
1747,4,6988,157729075,256059356,0.615986
1748,3,5244,157734319,256059356,0.616007
1749,6,10494,157744813,256059356,0.616048
1750,3,5250,157750063,256059356,0.616068
1751,2,3502,157753565,256059356,0.616082
1752,5,8760,157762325,256059356,0.616116
1753,1,1753,157764078,256059356,0.616123
1755,2,3510,157767588,256059356,0.616137
1756,1,1756,157769344,256059356,0.616144
1757,2,3514,157772858,256059356,0.616157
1759,3,5277,157778135,256059356,0.616178
1760,1,1760,157779895,256059356,0.616185
1761,4,7044,157786939,256059356,0.616212
1762,1,1762,157788701,256059356,0.616219
1763,2,3526,157792227,256059356,0.616233
1764,3,5292,157797519,256059356,0.616254
1765,2,3530,157801049,256059356,0.616267
1766,4,7064,157808113,256059356,0.616295
1767,1,1767,157809880,256059356,0.616302
1768,3,5304,157815184,256059356,0.616323
1769,3,5307,157820491,256059356,0.616343
1770,3,5310,157825801,256059356,0.616364
1771,2,3542,157829343,256059356,0.616378
1772,3,5316,157834659,256059356,0.616399
1773,1,1773,157836432,256059356,0.616406
1774,2,3548,157839980,256059356,0.616419
1775,1,1775,157841755,256059356,0.616426
1776,2,3552,157845307,256059356,0.61644
1777,1,1777,157847084,256059356,0.616447
1778,1,1778,157848862,256059356,0.616454
1779,4,7116,157855978,256059356,0.616482
1780,2,3560,157859538,256059356,0.616496
1781,6,10686,157870224,256059356,0.616538
1782,6,10692,157880916,256059356,0.616579
1783,1,1783,157882699,256059356,0.616586
1784,5,8920,157891619,256059356,0.616621
1785,5,8925,157900544,256059356,0.616656
1786,2,3572,157904116,256059356,0.61667
1787,3,5361,157909477,256059356,0.616691
1788,2,3576,157913053,256059356,0.616705
1789,2,3578,157916631,256059356,0.616719
1790,5,8950,157925581,256059356,0.616754
1791,3,5373,157930954,256059356,0.616775
1792,3,5376,157936330,256059356,0.616796
1793,1,1793,157938123,256059356,0.616803
1794,4,7176,157945299,256059356,0.616831
1795,2,3590,157948889,256059356,0.616845
1797,3,5391,157954280,256059356,0.616866
1798,4,7192,157961472,256059356,0.616894
1800,2,3600,157965072,256059356,0.616908
1801,2,3602,157968674,256059356,0.616922
1802,3,5406,157974080,256059356,0.616943
1803,4,7212,157981292,256059356,0.616971
1804,5,9020,157990312,256059356,0.617007
1805,4,7220,157997532,256059356,0.617035
1806,4,7224,158004756,256059356,0.617063
1807,2,3614,158008370,256059356,0.617077
1808,1,1808,158010178,256059356,0.617084
1810,5,9050,158019228,256059356,0.61712
1811,3,5433,158024661,256059356,0.617141
1812,3,5436,158030097,256059356,0.617162
1813,5,9065,158039162,256059356,0.617197
1814,4,7256,158046418,256059356,0.617226
1815,2,3630,158050048,256059356,0.61724
1817,1,1817,158051865,256059356,0.617247
1818,2,3636,158055501,256059356,0.617261
1819,2,3638,158059139,256059356,0.617275
1820,7,12740,158071879,256059356,0.617325
1821,1,1821,158073700,256059356,0.617332
1822,2,3644,158077344,256059356,0.617346
1823,5,9115,158086459,256059356,0.617382
1824,3,5472,158091931,256059356,0.617403
1825,2,3650,158095581,256059356,0.617418
1826,1,1826,158097407,256059356,0.617425
1827,1,1827,158099234,256059356,0.617432
1828,1,1828,158101062,256059356,0.617439
1829,6,10974,158112036,256059356,0.617482
1830,2,3660,158115696,256059356,0.617496
1832,1,1832,158117528,256059356,0.617503
1833,5,9165,158126693,256059356,0.617539
1834,2,3668,158130361,256059356,0.617554
1835,1,1835,158132196,256059356,0.617561
1836,2,3672,158135868,256059356,0.617575
1837,2,3674,158139542,256059356,0.617589
1838,1,1838,158141380,256059356,0.617597
1839,2,3678,158145058,256059356,0.617611
1840,5,9200,158154258,256059356,0.617647
1841,2,3682,158157940,256059356,0.617661
1842,4,7368,158165308,256059356,0.61769
1843,2,3686,158168994,256059356,0.617704
1844,7,12908,158181902,256059356,0.617755
1845,5,9225,158191127,256059356,0.617791
1846,2,3692,158194819,256059356,0.617805
1847,3,5541,158200360,256059356,0.617827
1848,3,5544,158205904,256059356,0.617849
1849,6,11094,158216998,256059356,0.617892
1850,5,9250,158226248,256059356,0.617928
1851,6,11106,158237354,256059356,0.617971
1852,2,3704,158241058,256059356,0.617986
1853,4,7412,158248470,256059356,0.618015
1855,2,3710,158252180,256059356,0.618029
1856,5,9280,158261460,256059356,0.618066
1857,5,9285,158270745,256059356,0.618102
1858,2,3716,158274461,256059356,0.618116
1859,2,3718,158278179,256059356,0.618131
1860,1,1860,158280039,256059356,0.618138
1861,1,1861,158281900,256059356,0.618145
1862,3,5586,158287486,256059356,0.618167
1863,2,3726,158291212,256059356,0.618182
1864,4,7456,158298668,256059356,0.618211
1865,2,3730,158302398,256059356,0.618225
1866,4,7464,158309862,256059356,0.618255
1867,2,3734,158313596,256059356,0.618269
1868,3,5604,158319200,256059356,0.618291
1869,2,3738,158322938,256059356,0.618306
1870,3,5610,158328548,256059356,0.618328
1871,3,5613,158334161,256059356,0.618349
1872,4,7488,158341649,256059356,0.618379
1873,1,1873,158343522,256059356,0.618386
1874,1,1874,158345396,256059356,0.618393
1875,4,7500,158352896,256059356,0.618423
1876,2,3752,158356648,256059356,0.618437
1877,3,5631,158362279,256059356,0.618459
1878,7,13146,158375425,256059356,0.618511
1879,3,5637,158381062,256059356,0.618533
1880,2,3760,158384822,256059356,0.618547
1881,1,1881,158386703,256059356,0.618555
1882,3,5646,158392349,256059356,0.618577
1883,2,3766,158396115,256059356,0.618591
1884,2,3768,158399883,256059356,0.618606
1885,3,5655,158405538,256059356,0.618628
1886,2,3772,158409310,256059356,0.618643
1887,2,3774,158413084,256059356,0.618658
1888,3,5664,158418748,256059356,0.61868
1889,3,5667,158424415,256059356,0.618702
1890,1,1890,158426305,256059356,0.618709
1891,2,3782,158430087,256059356,0.618724
1892,4,7568,158437655,256059356,0.618754
1893,1,1893,158439548,256059356,0.618761
1894,3,5682,158445230,256059356,0.618783
1895,1,1895,158447125,256059356,0.618791
1896,3,5688,158452813,256059356,0.618813
1897,1,1897,158454710,256059356,0.61882
1898,2,3796,158458506,256059356,0.618835
1899,2,3798,158462304,256059356,0.61885
1900,3,5700,158468004,256059356,0.618872
1901,3,5703,158473707,256059356,0.618894
1902,3,5706,158479413,256059356,0.618917
1903,1,1903,158481316,256059356,0.618924
1904,1,1904,158483220,256059356,0.618932
1905,2,3810,158487030,256059356,0.618946
1906,3,5718,158492748,256059356,0.618969
1907,1,1907,158494655,256059356,0.618976
1908,5,9540,158504195,256059356,0.619013
1909,2,3818,158508013,256059356,0.619028
1910,6,11460,158519473,256059356,0.619073
1911,2,3822,158523295,256059356,0.619088
1912,1,1912,158525207,256059356,0.619096
1913,2,3826,158529033,256059356,0.61911
1914,1,1914,158530947,256059356,0.619118
1915,4,7660,158538607,256059356,0.619148
1917,1,1917,158540524,256059356,0.619155
1918,3,5754,158546278,256059356,0.619178
1919,4,7676,158553954,256059356,0.619208
1920,3,5760,158559714,256059356,0.61923
1922,4,7688,158567402,256059356,0.61926
1923,5,9615,158577017,256059356,0.619298
1924,2,3848,158580865,256059356,0.619313
1925,2,3850,158584715,256059356,0.619328
1926,3,5778,158590493,256059356,0.619351
1927,3,5781,158596274,256059356,0.619373
1928,1,1928,158598202,256059356,0.619381
1929,2,3858,158602060,256059356,0.619396
1930,3,5790,158607850,256059356,0.619418
1931,2,3862,158611712,256059356,0.619433
1932,5,9660,158621372,256059356,0.619471
1933,2,3866,158625238,256059356,0.619486
1934,2,3868,158629106,256059356,0.619501
1935,3,5805,158634911,256059356,0.619524
1936,4,7744,158642655,256059356,0.619554
1937,3,5811,158648466,256059356,0.619577
1938,4,7752,158656218,256059356,0.619607
1940,1,1940,158658158,256059356,0.619615
1941,3,5823,158663981,256059356,0.619638
1942,2,3884,158667865,256059356,0.619653
1943,1,1943,158669808,256059356,0.61966
1944,2,3888,158673696,256059356,0.619675
1945,2,3890,158677586,256059356,0.619691
1946,1,1946,158679532,256059356,0.619698
1949,4,7796,158687328,256059356,0.619729
1950,1,1950,158689278,256059356,0.619736
1951,2,3902,158693180,256059356,0.619752
1953,1,1953,158695133,256059356,0.619759
1954,2,3908,158699041,256059356,0.619774
1956,7,13692,158712733,256059356,0.619828
1957,2,3914,158716647,256059356,0.619843
1958,4,7832,158724479,256059356,0.619874
1959,1,1959,158726438,256059356,0.619881
1960,1,1960,158728398,256059356,0.619889
1961,3,5883,158734281,256059356,0.619912
1962,1,1962,158736243,256059356,0.61992
1965,1,1965,158738208,256059356,0.619927
1966,3,5898,158744106,256059356,0.61995
1967,3,5901,158750007,256059356,0.619973
1968,1,1968,158751975,256059356,0.619981
1969,1,1969,158753944,256059356,0.619989
1970,4,7880,158761824,256059356,0.62002
1971,2,3942,158765766,256059356,0.620035
1972,1,1972,158767738,256059356,0.620043
1973,5,9865,158777603,256059356,0.620081
1974,2,3948,158781551,256059356,0.620097
1975,3,5925,158787476,256059356,0.62012
1976,1,1976,158789452,256059356,0.620128
1977,9,17793,158807245,256059356,0.620197
1978,3,5934,158813179,256059356,0.62022
1980,3,5940,158819119,256059356,0.620243
1981,1,1981,158821100,256059356,0.620251
1982,1,1982,158823082,256059356,0.620259
1983,3,5949,158829031,256059356,0.620282
1984,2,3968,158832999,256059356,0.620298
1985,2,3970,158836969,256059356,0.620313
1986,1,1986,158838955,256059356,0.620321
1987,1,1987,158840942,256059356,0.620329
1988,2,3976,158844918,256059356,0.620344
1989,2,3978,158848896,256059356,0.62036
1991,2,3982,158852878,256059356,0.620375
1992,3,5976,158858854,256059356,0.620399
1993,5,9965,158868819,256059356,0.620437
1994,3,5982,158874801,256059356,0.620461
1995,3,5985,158880786,256059356,0.620484
1996,3,5988,158886774,256059356,0.620508
1997,1,1997,158888771,256059356,0.620515
1998,3,5994,158894765,256059356,0.620539
2001,2,4002,158898767,256059356,0.620554
2002,9,18018,158916785,256059356,0.620625
2003,2,4006,158920791,256059356,0.62064
2004,3,6012,158926803,256059356,0.620664
2005,1,2005,158928808,256059356,0.620672
2006,3,6018,158934826,256059356,0.620695
2008,1,2008,158936834,256059356,0.620703
2009,4,8036,158944870,256059356,0.620734
2010,3,6030,158950900,256059356,0.620758
2011,3,6033,158956933,256059356,0.620782
2012,3,6036,158962969,256059356,0.620805
2013,1,2013,158964982,256059356,0.620813
2014,2,4028,158969010,256059356,0.620829
2015,4,8060,158977070,256059356,0.62086
2016,2,4032,158981102,256059356,0.620876
2017,1,2017,158983119,256059356,0.620884
2019,2,4038,158987157,256059356,0.6209
2020,3,6060,158993217,256059356,0.620923
2021,1,2021,158995238,256059356,0.620931
2022,2,4044,158999282,256059356,0.620947
2023,3,6069,159005351,256059356,0.620971
2024,3,6072,159011423,256059356,0.620994
2025,3,6075,159017498,256059356,0.621018
2026,3,6078,159023576,256059356,0.621042
2027,2,4054,159027630,256059356,0.621058
2028,2,4056,159031686,256059356,0.621074
2029,2,4058,159035744,256059356,0.621089
2030,3,6090,159041834,256059356,0.621113
2031,1,2031,159043865,256059356,0.621121
2032,5,10160,159054025,256059356,0.621161
2034,3,6102,159060127,256059356,0.621185
2035,1,2035,159062162,256059356,0.621193
2037,1,2037,159064199,256059356,0.6212
2038,1,2038,159066237,256059356,0.621208
2039,1,2039,159068276,256059356,0.621216
2040,5,10200,159078476,256059356,0.621256
2041,2,4082,159082558,256059356,0.621272
2043,4,8172,159090730,256059356,0.621304
2044,8,16352,159107082,256059356,0.621368
2046,4,8184,159115266,256059356,0.6214
2047,2,4094,159119360,256059356,0.621416
2048,3,6144,159125504,256059356,0.62144
2050,2,4100,159129604,256059356,0.621456
2051,1,2051,159131655,256059356,0.621464
2052,4,8208,159139863,256059356,0.621496
2053,2,4106,159143969,256059356,0.621512
2054,3,6162,159150131,256059356,0.621536
2055,1,2055,159152186,256059356,0.621544
2056,3,6168,159158354,256059356,0.621568
2057,3,6171,159164525,256059356,0.621592
2059,3,6177,159170702,256059356,0.621616
2060,2,4120,159174822,256059356,0.621633
2061,2,4122,159178944,256059356,0.621649
2062,3,6186,159185130,256059356,0.621673
2063,2,4126,159189256,256059356,0.621689
2064,4,8256,159197512,256059356,0.621721
2065,2,4130,159201642,256059356,0.621737
2066,2,4132,159205774,256059356,0.621753
2067,1,2067,159207841,256059356,0.621761
2068,2,4136,159211977,256059356,0.621778
2070,1,2070,159214047,256059356,0.621786
2071,2,4142,159218189,256059356,0.621802
2072,3,6216,159224405,256059356,0.621826
2073,2,4146,159228551,256059356,0.621842
2074,4,8296,159236847,256059356,0.621875
2075,3,6225,159243072,256059356,0.621899
2076,2,4152,159247224,256059356,0.621915
2077,2,4154,159251378,256059356,0.621931
2078,1,2078,159253456,256059356,0.62194
2079,2,4158,159257614,256059356,0.621956
2080,2,4160,159261774,256059356,0.621972
2081,1,2081,159263855,256059356,0.62198
2082,6,12492,159276347,256059356,0.622029
2083,2,4166,159280513,256059356,0.622045
2084,1,2084,159282597,256059356,0.622053
2085,4,8340,159290937,256059356,0.622086
2086,1,2086,159293023,256059356,0.622094
2087,4,8348,159301371,256059356,0.622127
2088,1,2088,159303459,256059356,0.622135
2089,1,2089,159305548,256059356,0.622143
2090,1,2090,159307638,256059356,0.622151
2091,2,4182,159311820,256059356,0.622168
2093,3,6279,159318099,256059356,0.622192
2095,4,8380,159326479,256059356,0.622225
2097,1,2097,159328576,256059356,0.622233
2098,4,8392,159336968,256059356,0.622266
2099,3,6297,159343265,256059356,0.62229
2100,3,6300,159349565,256059356,0.622315
2101,4,8404,159357969,256059356,0.622348
2102,2,4204,159362173,256059356,0.622364
2103,5,10515,159372688,256059356,0.622405
2105,3,6315,159379003,256059356,0.62243
2106,1,2106,159381109,256059356,0.622438
2107,1,2107,159383216,256059356,0.622446
2108,4,8432,159391648,256059356,0.622479
2109,5,10545,159402193,256059356,0.62252
2110,2,4220,159406413,256059356,0.622537
2111,1,2111,159408524,256059356,0.622545
2112,6,12672,159421196,256059356,0.622595
2114,2,4228,159425424,256059356,0.622611
2115,3,6345,159431769,256059356,0.622636
2116,3,6348,159438117,256059356,0.622661
2117,2,4234,159442351,256059356,0.622677
2118,2,4236,159446587,256059356,0.622694
2119,3,6357,159452944,256059356,0.622719
2120,3,6360,159459304,256059356,0.622744
2122,3,6366,159465670,256059356,0.622768
2123,2,4246,159469916,256059356,0.622785
2124,1,2124,159472040,256059356,0.622793
2125,5,10625,159482665,256059356,0.622835
2126,3,6378,159489043,256059356,0.62286
2128,2,4256,159493299,256059356,0.622876
2129,2,4258,159497557,256059356,0.622893
2130,2,4260,159501817,256059356,0.62291
2131,1,2131,159503948,256059356,0.622918
2133,3,6399,159510347,256059356,0.622943
2134,2,4268,159514615,256059356,0.62296
2135,4,8540,159523155,256059356,0.622993
2137,1,2137,159525292,256059356,0.623001
2139,1,2139,159527431,256059356,0.62301
2140,4,8560,159535991,256059356,0.623043
2141,2,4282,159540273,256059356,0.62306
2142,2,4284,159544557,256059356,0.623076
2143,1,2143,159546700,256059356,0.623085
2144,1,2144,159548844,256059356,0.623093
2145,2,4290,159553134,256059356,0.62311
2147,5,10735,159563869,256059356,0.623152
2148,4,8592,159572461,256059356,0.623185
2149,1,2149,159574610,256059356,0.623194
2151,1,2151,159576761,256059356,0.623202
2152,4,8608,159585369,256059356,0.623236
2153,2,4306,159589675,256059356,0.623253
2154,3,6462,159596137,256059356,0.623278
2155,1,2155,159598292,256059356,0.623286
2156,3,6468,159604760,256059356,0.623312
2157,2,4314,159609074,256059356,0.623328
2158,3,6474,159615548,256059356,0.623354
2159,1,2159,159617707,256059356,0.623362
2161,1,2161,159619868,256059356,0.623371
2162,1,2162,159622030,256059356,0.623379
2163,1,2163,159624193,256059356,0.623387
2164,1,2164,159626357,256059356,0.623396
2165,2,4330,159630687,256059356,0.623413
2166,2,4332,159635019,256059356,0.62343
2167,1,2167,159637186,256059356,0.623438
2168,5,10840,159648026,256059356,0.623481
2169,1,2169,159650195,256059356,0.623489
2170,4,8680,159658875,256059356,0.623523
2171,4,8684,159667559,256059356,0.623557
2172,4,8688,159676247,256059356,0.623591
2173,2,4346,159680593,256059356,0.623608
2174,5,10870,159691463,256059356,0.62365
2175,1,2175,159693638,256059356,0.623659
2176,6,13056,159706694,256059356,0.62371
2177,5,10885,159717579,256059356,0.623752
2178,3,6534,159724113,256059356,0.623778
2179,3,6537,159730650,256059356,0.623803
2180,1,2180,159732830,256059356,0.623812
2181,2,4362,159737192,256059356,0.623829
2182,3,6546,159743738,256059356,0.623854
2183,3,6549,159750287,256059356,0.62388
2184,4,8736,159759023,256059356,0.623914
2185,4,8740,159767763,256059356,0.623948
2186,4,8744,159776507,256059356,0.623982
2187,4,8748,159785255,256059356,0.624016
2188,1,2188,159787443,256059356,0.624025
2189,1,2189,159789632,256059356,0.624034
2190,1,2190,159791822,256059356,0.624042
2191,3,6573,159798395,256059356,0.624068
2192,3,6576,159804971,256059356,0.624093
2193,3,6579,159811550,256059356,0.624119
2194,5,10970,159822520,256059356,0.624162
2195,4,8780,159831300,256059356,0.624196
2196,2,4392,159835692,256059356,0.624213
2197,3,6591,159842283,256059356,0.624239
2198,1,2198,159844481,256059356,0.624248
2199,1,2199,159846680,256059356,0.624256
2200,1,2200,159848880,256059356,0.624265
2202,4,8808,159857688,256059356,0.624299
2203,1,2203,159859891,256059356,0.624308
2204,4,8816,159868707,256059356,0.624342
2205,2,4410,159873117,256059356,0.62436
2206,4,8824,159881941,256059356,0.624394
2207,6,13242,159895183,256059356,0.624446
2208,4,8832,159904015,256059356,0.62448
2209,4,8836,159912851,256059356,0.624515
2210,2,4420,159917271,256059356,0.624532
2211,2,4422,159921693,256059356,0.624549
2212,4,8848,159930541,256059356,0.624584
2213,4,8852,159939393,256059356,0.624618
2214,2,4428,159943821,256059356,0.624636
2215,2,4430,159948251,256059356,0.624653
2217,1,2217,159950468,256059356,0.624662
2218,1,2218,159952686,256059356,0.62467
2219,2,4438,159957124,256059356,0.624688
2220,3,6660,159963784,256059356,0.624714
2221,2,4442,159968226,256059356,0.624731
2224,3,6672,159974898,256059356,0.624757
2225,1,2225,159977123,256059356,0.624766
2226,3,6678,159983801,256059356,0.624792
2227,2,4454,159988255,256059356,0.624809
2228,6,13368,160001623,256059356,0.624861
2230,1,2230,160003853,256059356,0.62487
2231,1,2231,160006084,256059356,0.624879
2232,2,4464,160010548,256059356,0.624896
2233,1,2233,160012781,256059356,0.624905
2234,1,2234,160015015,256059356,0.624914
2235,2,4470,160019485,256059356,0.624931
2236,1,2236,160021721,256059356,0.62494
2237,5,11185,160032906,256059356,0.624984
2238,1,2238,160035144,256059356,0.624992
2239,2,4478,160039622,256059356,0.62501
2240,5,11200,160050822,256059356,0.625054
2241,2,4482,160055304,256059356,0.625071
2242,1,2242,160057546,256059356,0.62508
2243,2,4486,160062032,256059356,0.625097
2244,2,4488,160066520,256059356,0.625115
2245,3,6735,160073255,256059356,0.625141
2246,5,11230,160084485,256059356,0.625185
2247,4,8988,160093473,256059356,0.62522
2248,1,2248,160095721,256059356,0.625229
2249,3,6747,160102468,256059356,0.625255
2251,5,11255,160113723,256059356,0.625299
2252,3,6756,160120479,256059356,0.625326
2253,1,2253,160122732,256059356,0.625334
2254,2,4508,160127240,256059356,0.625352
2255,2,4510,160131750,256059356,0.62537
2256,4,9024,160140774,256059356,0.625405
2257,3,6771,160147545,256059356,0.625431
2258,1,2258,160149803,256059356,0.62544
2259,1,2259,160152062,256059356,0.625449
2261,2,4522,160156584,256059356,0.625467
2262,2,4524,160161108,256059356,0.625484
2263,1,2263,160163371,256059356,0.625493
2264,2,4528,160167899,256059356,0.625511
2265,3,6795,160174694,256059356,0.625537
2267,1,2267,160176961,256059356,0.625546
2268,3,6804,160183765,256059356,0.625573
2269,1,2269,160186034,256059356,0.625582
2271,2,4542,160190576,256059356,0.625599
2272,4,9088,160199664,256059356,0.625635
2273,1,2273,160201937,256059356,0.625644
2274,4,9096,160211033,256059356,0.625679
2275,1,2275,160213308,256059356,0.625688
2276,1,2276,160215584,256059356,0.625697
2277,3,6831,160222415,256059356,0.625724
2278,1,2278,160224693,256059356,0.625733
2279,1,2279,160226972,256059356,0.625742
2280,2,4560,160231532,256059356,0.625759
2281,4,9124,160240656,256059356,0.625795
2283,1,2283,160242939,256059356,0.625804
2284,5,11420,160254359,256059356,0.625848
2286,3,6858,160261217,256059356,0.625875
2287,1,2287,160263504,256059356,0.625884
2288,2,4576,160268080,256059356,0.625902
2289,1,2289,160270369,256059356,0.625911
2290,1,2290,160272659,256059356,0.62592
2291,2,4582,160277241,256059356,0.625938
2292,1,2292,160279533,256059356,0.625947
2293,3,6879,160286412,256059356,0.625974
2294,1,2294,160288706,256059356,0.625983
2297,6,13782,160302488,256059356,0.626036
2298,1,2298,160304786,256059356,0.626045
2299,1,2299,160307085,256059356,0.626054
2300,2,4600,160311685,256059356,0.626072
2301,1,2301,160313986,256059356,0.626081
2302,4,9208,160323194,256059356,0.626117
2303,1,2303,160325497,256059356,0.626126
2304,3,6912,160332409,256059356,0.626153
2305,1,2305,160334714,256059356,0.626162
2307,2,4614,160339328,256059356,0.62618
2308,3,6924,160346252,256059356,0.626207
2309,1,2309,160348561,256059356,0.626216
2310,3,6930,160355491,256059356,0.626243
2311,2,4622,160360113,256059356,0.626261
2312,3,6936,160367049,256059356,0.626289
2313,1,2313,160369362,256059356,0.626298
2314,3,6942,160376304,256059356,0.626325
2315,4,9260,160385564,256059356,0.626361
2316,1,2316,160387880,256059356,0.62637
2317,3,6951,160394831,256059356,0.626397
2318,1,2318,160397149,256059356,0.626406
2320,1,2320,160399469,256059356,0.626415
2321,5,11605,160411074,256059356,0.626461
2323,5,11615,160422689,256059356,0.626506
2324,2,4648,160427337,256059356,0.626524
2325,5,11625,160438962,256059356,0.626569
2326,2,4652,160443614,256059356,0.626588
2327,3,6981,160450595,256059356,0.626615
2328,2,4656,160455251,256059356,0.626633
2330,1,2330,160457581,256059356,0.626642
2331,5,11655,160469236,256059356,0.626688
2332,1,2332,160471568,256059356,0.626697
2333,4,9332,160480900,256059356,0.626733
2335,1,2335,160483235,256059356,0.626742
2336,1,2336,160485571,256059356,0.626751
2337,3,7011,160492582,256059356,0.626779
2338,1,2338,160494920,256059356,0.626788
2339,3,7017,160501937,256059356,0.626815
2340,3,7020,160508957,256059356,0.626843
2344,1,2344,160511301,256059356,0.626852
2346,1,2346,160513647,256059356,0.626861
2347,1,2347,160515994,256059356,0.62687
2349,1,2349,160518343,256059356,0.626879
2350,4,9400,160527743,256059356,0.626916
2351,2,4702,160532445,256059356,0.626935
2352,2,4704,160537149,256059356,0.626953
2353,2,4706,160541855,256059356,0.626971
2354,4,9416,160551271,256059356,0.627008
2355,2,4710,160555981,256059356,0.627026
2356,1,2356,160558337,256059356,0.627036
2357,1,2357,160560694,256059356,0.627045
2359,2,4718,160565412,256059356,0.627063
2360,3,7080,160572492,256059356,0.627091
2361,3,7083,160579575,256059356,0.627119
2362,2,4724,160584299,256059356,0.627137
2363,2,4726,160589025,256059356,0.627155
2364,5,11820,160600845,256059356,0.627202
2365,2,4730,160605575,256059356,0.62722
2366,1,2366,160607941,256059356,0.627229
2368,1,2368,160610309,256059356,0.627239
2369,3,7107,160617416,256059356,0.627266
2370,1,2370,160619786,256059356,0.627276
2371,2,4742,160624528,256059356,0.627294
2372,1,2372,160626900,256059356,0.627303
2373,2,4746,160631646,256059356,0.627322
2374,1,2374,160634020,256059356,0.627331
2375,1,2375,160636395,256059356,0.62734
2376,2,4752,160641147,256059356,0.627359
2377,1,2377,160643524,256059356,0.627368
2378,1,2378,160645902,256059356,0.627378
2379,3,7137,160653039,256059356,0.627405
2380,2,4760,160657799,256059356,0.627424
2381,2,4762,160662561,256059356,0.627443
2382,1,2382,160664943,256059356,0.627452
2383,2,4766,160669709,256059356,0.627471
2384,2,4768,160674477,256059356,0.627489
2385,3,7155,160681632,256059356,0.627517
2386,2,4772,160686404,256059356,0.627536
2387,2,4774,160691178,256059356,0.627554
2388,1,2388,160693566,256059356,0.627564
2389,2,4778,160698344,256059356,0.627582
2390,1,2390,160700734,256059356,0.627592
2391,1,2391,160703125,256059356,0.627601
2392,1,2392,160705517,256059356,0.62761
2394,2,4788,160710305,256059356,0.627629
2395,1,2395,160712700,256059356,0.627638
2396,1,2396,160715096,256059356,0.627648
2397,5,11985,160727081,256059356,0.627695
2398,3,7194,160734275,256059356,0.627723
2399,2,4798,160739073,256059356,0.627741
2401,2,4802,160743875,256059356,0.62776
2402,2,4804,160748679,256059356,0.627779
2403,2,4806,160753485,256059356,0.627798
2406,4,9624,160763109,256059356,0.627835
2408,2,4816,160767925,256059356,0.627854
2409,4,9636,160777561,256059356,0.627892
2410,1,2410,160779971,256059356,0.627901
2411,3,7233,160787204,256059356,0.627929
2412,3,7236,160794440,256059356,0.627958
2413,3,7239,160801679,256059356,0.627986
2414,4,9656,160811335,256059356,0.628024
2415,4,9660,160820995,256059356,0.628061
2416,1,2416,160823411,256059356,0.628071
2417,3,7251,160830662,256059356,0.628099
2418,1,2418,160833080,256059356,0.628109
2419,1,2419,160835499,256059356,0.628118
2420,2,4840,160840339,256059356,0.628137
2421,1,2421,160842760,256059356,0.628146
2422,3,7266,160850026,256059356,0.628175
2423,3,7269,160857295,256059356,0.628203
2424,4,9696,160866991,256059356,0.628241
2425,7,16975,160883966,256059356,0.628307
2426,3,7278,160891244,256059356,0.628336
2427,3,7281,160898525,256059356,0.628364
2428,3,7284,160905809,256059356,0.628393
2429,2,4858,160910667,256059356,0.628412
2431,1,2431,160913098,256059356,0.628421
2432,4,9728,160922826,256059356,0.628459
2433,2,4866,160927692,256059356,0.628478
2434,4,9736,160937428,256059356,0.628516
2435,1,2435,160939863,256059356,0.628526
2436,2,4872,160944735,256059356,0.628545
2438,1,2438,160947173,256059356,0.628554
2439,1,2439,160949612,256059356,0.628564
2440,4,9760,160959372,256059356,0.628602
2442,1,2442,160961814,256059356,0.628611
2443,2,4886,160966700,256059356,0.62863
2444,4,9776,160976476,256059356,0.628669
2445,1,2445,160978921,256059356,0.628678
2446,1,2446,160981367,256059356,0.628688
2448,1,2448,160983815,256059356,0.628697
2449,5,12245,160996060,256059356,0.628745
2450,1,2450,160998510,256059356,0.628755
2451,3,7353,161005863,256059356,0.628783
2452,2,4904,161010767,256059356,0.628803
2453,3,7359,161018126,256059356,0.628831
2454,3,7362,161025488,256059356,0.62886
2455,2,4910,161030398,256059356,0.628879
2457,4,9828,161040226,256059356,0.628918
2459,4,9836,161050062,256059356,0.628956
2460,3,7380,161057442,256059356,0.628985
2461,3,7383,161064825,256059356,0.629014
2462,2,4924,161069749,256059356,0.629033
2463,2,4926,161074675,256059356,0.629052
2465,3,7395,161082070,256059356,0.629081
2467,1,2467,161084537,256059356,0.629091
2468,2,4936,161089473,256059356,0.62911
2469,6,14814,161104287,256059356,0.629168
2471,6,14826,161119113,256059356,0.629226
2472,5,12360,161131473,256059356,0.629274
2473,2,4946,161136419,256059356,0.629293
2474,3,7422,161143841,256059356,0.629322
2475,5,12375,161156216,256059356,0.629371
2476,1,2476,161158692,256059356,0.62938
2477,1,2477,161161169,256059356,0.62939
2481,2,4962,161166131,256059356,0.629409
2482,1,2482,161168613,256059356,0.629419
2483,1,2483,161171096,256059356,0.629429
2484,2,4968,161176064,256059356,0.629448
2485,1,2485,161178549,256059356,0.629458
2486,1,2486,161181035,256059356,0.629467
2487,1,2487,161183522,256059356,0.629477
2488,2,4976,161188498,256059356,0.629497
2489,1,2489,161190987,256059356,0.629506
2490,2,4980,161195967,256059356,0.629526
2491,1,2491,161198458,256059356,0.629536
2492,2,4984,161203442,256059356,0.629555
2493,1,2493,161205935,256059356,0.629565
2495,6,14970,161220905,256059356,0.629623
2496,3,7488,161228393,256059356,0.629652
2497,2,4994,161233387,256059356,0.629672
2498,1,2498,161235885,256059356,0.629682
2499,1,2499,161238384,256059356,0.629691
2500,4,10000,161248384,256059356,0.62973
2501,2,5002,161253386,256059356,0.62975
2502,1,2502,161255888,256059356,0.62976
2503,3,7509,161263397,256059356,0.629789
2504,3,7512,161270909,256059356,0.629818
2505,4,10020,161280929,256059356,0.629858
2506,6,15036,161295965,256059356,0.629916
2507,3,7521,161303486,256059356,0.629946
2508,1,2508,161305994,256059356,0.629955
2509,2,5018,161311012,256059356,0.629975
2510,2,5020,161316032,256059356,0.629995
2511,6,15066,161331098,256059356,0.630054
2512,1,2512,161333610,256059356,0.630063
2513,6,15078,161348688,256059356,0.630122
2514,2,5028,161353716,256059356,0.630142
2515,2,5030,161358746,256059356,0.630161
2517,1,2517,161361263,256059356,0.630171
2518,3,7554,161368817,256059356,0.630201
2519,2,5038,161373855,256059356,0.63022
2520,1,2520,161376375,256059356,0.63023
2521,2,5042,161381417,256059356,0.63025
2522,1,2522,161383939,256059356,0.63026
2523,1,2523,161386462,256059356,0.63027
2524,4,10096,161396558,256059356,0.630309
2525,2,5050,161401608,256059356,0.630329
2526,1,2526,161404134,256059356,0.630339
2527,4,10108,161414242,256059356,0.630378
2528,1,2528,161416770,256059356,0.630388
2529,4,10116,161426886,256059356,0.630428
2530,1,2530,161429416,256059356,0.630437
2531,2,5062,161434478,256059356,0.630457
2532,2,5064,161439542,256059356,0.630477
2533,4,10132,161449674,256059356,0.630517
2534,1,2534,161452208,256059356,0.630526
2535,7,17745,161469953,256059356,0.630596
2536,1,2536,161472489,256059356,0.630606
2538,3,7614,161480103,256059356,0.630635
2539,1,2539,161482642,256059356,0.630645
2540,1,2540,161485182,256059356,0.630655
2541,3,7623,161492805,256059356,0.630685
2545,1,2545,161495350,256059356,0.630695
2546,1,2546,161497896,256059356,0.630705
2547,2,5094,161502990,256059356,0.630725
2548,1,2548,161505538,256059356,0.630735
2549,1,2549,161508087,256059356,0.630745
2551,1,2551,161510638,256059356,0.630755
2552,1,2552,161513190,256059356,0.630765
2553,2,5106,161518296,256059356,0.630785
2555,1,2555,161520851,256059356,0.630795
2556,1,2556,161523407,256059356,0.630805
2558,3,7674,161531081,256059356,0.630835
2559,1,2559,161533640,256059356,0.630845
2560,3,7680,161541320,256059356,0.630875
2562,2,5124,161546444,256059356,0.630895
2564,1,2564,161549008,256059356,0.630905
2565,2,5130,161554138,256059356,0.630925
2566,5,12830,161566968,256059356,0.630975
2567,3,7701,161574669,256059356,0.631005
2568,2,5136,161579805,256059356,0.631025
2569,1,2569,161582374,256059356,0.631035
2570,3,7710,161590084,256059356,0.631065
2573,1,2573,161592657,256059356,0.631075
2574,2,5148,161597805,256059356,0.631095
2575,4,10300,161608105,256059356,0.631135
2576,2,5152,161613257,256059356,0.631155
2577,1,2577,161615834,256059356,0.631166
2578,3,7734,161623568,256059356,0.631196
2579,2,5158,161628726,256059356,0.631216
2580,1,2580,161631306,256059356,0.631226
2581,2,5162,161636468,256059356,0.631246
2582,2,5164,161641632,256059356,0.631266
2583,2,5166,161646798,256059356,0.631286
2585,2,5170,161651968,256059356,0.631307
2587,1,2587,161654555,256059356,0.631317
2588,1,2588,161657143,256059356,0.631327
2589,1,2589,161659732,256059356,0.631337
2591,6,15546,161675278,256059356,0.631398
2592,2,5184,161680462,256059356,0.631418
2593,2,5186,161685648,256059356,0.631438
2594,2,5188,161690836,256059356,0.631458
2595,1,2595,161693431,256059356,0.631469
2597,3,7791,161701222,256059356,0.631499
2599,3,7797,161709019,256059356,0.631529
2600,2,5200,161714219,256059356,0.63155
2601,1,2601,161716820,256059356,0.63156
2602,2,5204,161722024,256059356,0.63158
2603,1,2603,161724627,256059356,0.63159
2604,2,5208,161729835,256059356,0.631611
2605,1,2605,161732440,256059356,0.631621
2606,1,2606,161735046,256059356,0.631631
2608,2,5216,161740262,256059356,0.631651
2609,1,2609,161742871,256059356,0.631662
2610,3,7830,161750701,256059356,0.631692
2613,2,5226,161755927,256059356,0.631713
2614,2,5228,161761155,256059356,0.631733
2616,1,2616,161763771,256059356,0.631743
2617,2,5234,161769005,256059356,0.631764
2618,5,13090,161782095,256059356,0.631815
2621,2,5242,161787337,256059356,0.631835
2622,7,18354,161805691,256059356,0.631907
2623,3,7869,161813560,256059356,0.631938
2624,7,18368,161831928,256059356,0.632009
2625,1,2625,161834553,256059356,0.63202
2626,4,10504,161845057,256059356,0.632061
2627,2,5254,161850311,256059356,0.632081
2628,2,5256,161855567,256059356,0.632102
2629,3,7887,161863454,256059356,0.632133
2632,1,2632,161866086,256059356,0.632143
2633,2,5266,161871352,256059356,0.632163
2634,1,2634,161873986,256059356,0.632174
2636,2,5272,161879258,256059356,0.632194
2637,1,2637,161881895,256059356,0.632205
2638,3,7914,161889809,256059356,0.632235
2639,1,2639,161892448,256059356,0.632246
2640,1,2640,161895088,256059356,0.632256
2641,3,7923,161903011,256059356,0.632287
2642,3,7926,161910937,256059356,0.632318
2643,5,13215,161924152,256059356,0.63237
2644,1,2644,161926796,256059356,0.63238
2645,2,5290,161932086,256059356,0.632401
2646,1,2646,161934732,256059356,0.632411
2647,1,2647,161937379,256059356,0.632421
2648,3,7944,161945323,256059356,0.632452
2650,1,2650,161947973,256059356,0.632463
2651,1,2651,161950624,256059356,0.632473
2652,1,2652,161953276,256059356,0.632483
2654,1,2654,161955930,256059356,0.632494
2655,1,2655,161958585,256059356,0.632504
2656,1,2656,161961241,256059356,0.632514
2658,1,2658,161963899,256059356,0.632525
2659,2,5318,161969217,256059356,0.632546
2660,2,5320,161974537,256059356,0.632566
2661,2,5322,161979859,256059356,0.632587
2663,3,7989,161987848,256059356,0.632618
2665,2,5330,161993178,256059356,0.632639
2666,1,2666,161995844,256059356,0.63265
2667,4,10668,162006512,256059356,0.632691
2668,2,5336,162011848,256059356,0.632712
2669,1,2669,162014517,256059356,0.632723
2670,4,10680,162025197,256059356,0.632764
2671,1,2671,162027868,256059356,0.632775
2672,4,10688,162038556,256059356,0.632816
2673,2,5346,162043902,256059356,0.632837
2676,1,2676,162046578,256059356,0.632848
2677,1,2677,162049255,256059356,0.632858
2678,1,2678,162051933,256059356,0.632869
2679,3,8037,162059970,256059356,0.6329
2680,3,8040,162068010,256059356,0.632931
2681,2,5362,162073372,256059356,0.632952
2683,1,2683,162076055,256059356,0.632963
2684,1,2684,162078739,256059356,0.632973
2685,2,5370,162084109,256059356,0.632994
2687,2,5374,162089483,256059356,0.633015
2689,1,2689,162092172,256059356,0.633026
2690,1,2690,162094862,256059356,0.633036
2691,1,2691,162097553,256059356,0.633047
2692,1,2692,162100245,256059356,0.633057
2693,4,10772,162111017,256059356,0.633099
2694,1,2694,162113711,256059356,0.63311
2695,2,5390,162119101,256059356,0.633131
2697,1,2697,162121798,256059356,0.633141
2698,2,5396,162127194,256059356,0.633163
2699,2,5398,162132592,256059356,0.633184
2700,1,2700,162135292,256059356,0.633194
2701,2,5402,162140694,256059356,0.633215
2702,2,5404,162146098,256059356,0.633236
2703,2,5406,162151504,256059356,0.633257
2704,7,18928,162170432,256059356,0.633331
2705,2,5410,162175842,256059356,0.633353
2706,2,5412,162181254,256059356,0.633374
2707,2,5414,162186668,256059356,0.633395
2708,2,5416,162192084,256059356,0.633416
2710,1,2710,162194794,256059356,0.633427
2711,4,10844,162205638,256059356,0.633469
2712,1,2712,162208350,256059356,0.633479
2715,2,5430,162213780,256059356,0.633501
2716,2,5432,162219212,256059356,0.633522
2717,1,2717,162221929,256059356,0.633533
2718,1,2718,162224647,256059356,0.633543
2719,2,5438,162230085,256059356,0.633564
2720,3,8160,162238245,256059356,0.633596
2721,1,2721,162240966,256059356,0.633607
2722,1,2722,162243688,256059356,0.633617
2725,2,5450,162249138,256059356,0.633639
2726,2,5452,162254590,256059356,0.63366
2727,1,2727,162257317,256059356,0.633671
2728,2,5456,162262773,256059356,0.633692
2729,1,2729,162265502,256059356,0.633703
2730,1,2730,162268232,256059356,0.633713
2731,1,2731,162270963,256059356,0.633724
2733,2,5466,162276429,256059356,0.633745
2736,1,2736,162279165,256059356,0.633756
2739,3,8217,162287382,256059356,0.633788
2740,4,10960,162298342,256059356,0.633831
2741,1,2741,162301083,256059356,0.633842
2742,1,2742,162303825,256059356,0.633852
2743,2,5486,162309311,256059356,0.633874
2744,1,2744,162312055,256059356,0.633884
2745,1,2745,162314800,256059356,0.633895
2746,1,2746,162317546,256059356,0.633906
2747,2,5494,162323040,256059356,0.633927
2748,3,8244,162331284,256059356,0.63396
2750,2,5500,162336784,256059356,0.633981
2751,2,5502,162342286,256059356,0.634003
2753,1,2753,162345039,256059356,0.634013
2754,2,5508,162350547,256059356,0.634035
2756,1,2756,162353303,256059356,0.634046
2757,1,2757,162356060,256059356,0.634056
2759,1,2759,162358819,256059356,0.634067
2760,1,2760,162361579,256059356,0.634078
2761,1,2761,162364340,256059356,0.634089
2762,1,2762,162367102,256059356,0.634099
2763,1,2763,162369865,256059356,0.63411
2765,1,2765,162372630,256059356,0.634121
2766,1,2766,162375396,256059356,0.634132
2767,1,2767,162378163,256059356,0.634143
2768,2,5536,162383699,256059356,0.634164
2769,1,2769,162386468,256059356,0.634175
2770,2,5540,162392008,256059356,0.634197
2772,2,5544,162397552,256059356,0.634218
2773,2,5546,162403098,256059356,0.63424
2774,1,2774,162405872,256059356,0.634251
2775,1,2775,162408647,256059356,0.634262
2778,2,5556,162414203,256059356,0.634283
2779,1,2779,162416982,256059356,0.634294
2780,1,2780,162419762,256059356,0.634305
2781,1,2781,162422543,256059356,0.634316
2782,1,2782,162425325,256059356,0.634327
2783,2,5566,162430891,256059356,0.634349
2784,1,2784,162433675,256059356,0.634359
2785,1,2785,162436460,256059356,0.63437
2786,2,5572,162442032,256059356,0.634392
2787,1,2787,162444819,256059356,0.634403
2788,3,8364,162453183,256059356,0.634436
2789,1,2789,162455972,256059356,0.634447
2793,1,2793,162458765,256059356,0.634457
2794,3,8382,162467147,256059356,0.63449
2796,1,2796,162469943,256059356,0.634501
2797,2,5594,162475537,256059356,0.634523
2798,1,2798,162478335,256059356,0.634534
2800,1,2800,162481135,256059356,0.634545
2801,1,2801,162483936,256059356,0.634556
2802,2,5604,162489540,256059356,0.634578
2804,1,2804,162492344,256059356,0.634589
2805,1,2805,162495149,256059356,0.6346
2806,1,2806,162497955,256059356,0.63461
2807,1,2807,162500762,256059356,0.634621
2808,1,2808,162503570,256059356,0.634632
2811,4,11244,162514814,256059356,0.634676
2812,1,2812,162517626,256059356,0.634687
2814,1,2814,162520440,256059356,0.634698
2815,1,2815,162523255,256059356,0.634709
2816,2,5632,162528887,256059356,0.634731
2817,3,8451,162537338,256059356,0.634764
2818,1,2818,162540156,256059356,0.634775
2821,2,5642,162545798,256059356,0.634797
2825,1,2825,162548623,256059356,0.634808
2826,3,8478,162557101,256059356,0.634841
2827,1,2827,162559928,256059356,0.634853
2828,1,2828,162562756,256059356,0.634864
2829,2,5658,162568414,256059356,0.634886
2830,1,2830,162571244,256059356,0.634897
2831,2,5662,162576906,256059356,0.634919
2833,1,2833,162579739,256059356,0.63493
2834,1,2834,162582573,256059356,0.634941
2835,1,2835,162585408,256059356,0.634952
2836,2,5672,162591080,256059356,0.634974
2838,1,2838,162593918,256059356,0.634985
2839,4,11356,162605274,256059356,0.63503
2840,6,17040,162622314,256059356,0.635096
2841,1,2841,162625155,256059356,0.635107
2843,2,5686,162630841,256059356,0.635129
2844,1,2844,162633685,256059356,0.635141
2845,1,2845,162636530,256059356,0.635152
2846,1,2846,162639376,256059356,0.635163
2847,1,2847,162642223,256059356,0.635174
2849,2,5698,162647921,256059356,0.635196
2850,2,5700,162653621,256059356,0.635218
2851,1,2851,162656472,256059356,0.63523
2852,1,2852,162659324,256059356,0.635241
2853,1,2853,162662177,256059356,0.635252
2854,2,5708,162667885,256059356,0.635274
2855,1,2855,162670740,256059356,0.635285
2856,2,5712,162676452,256059356,0.635308
2857,1,2857,162679309,256059356,0.635319
2858,1,2858,162682167,256059356,0.63533
2860,2,5720,162687887,256059356,0.635352
2862,2,5724,162693611,256059356,0.635375
2864,2,5728,162699339,256059356,0.635397
2865,2,5730,162705069,256059356,0.635419
2866,3,8598,162713667,256059356,0.635453
2868,3,8604,162722271,256059356,0.635487
2869,1,2869,162725140,256059356,0.635498
2872,2,5744,162730884,256059356,0.63552
2873,1,2873,162733757,256059356,0.635531
2874,1,2874,162736631,256059356,0.635543
2877,1,2877,162739508,256059356,0.635554
2881,1,2881,162742389,256059356,0.635565
2882,1,2882,162745271,256059356,0.635576
2883,3,8649,162753920,256059356,0.63561
2885,3,8655,162762575,256059356,0.635644
2886,2,5772,162768347,256059356,0.635666
2887,5,14435,162782782,256059356,0.635723
2888,1,2888,162785670,256059356,0.635734
2889,2,5778,162791448,256059356,0.635757
2891,1,2891,162794339,256059356,0.635768
2895,5,14475,162808814,256059356,0.635825
2896,1,2896,162811710,256059356,0.635836
2897,3,8691,162820401,256059356,0.63587
2898,1,2898,162823299,256059356,0.635881
2900,2,5800,162829099,256059356,0.635904
2901,1,2901,162832000,256059356,0.635915
2902,1,2902,162834902,256059356,0.635926
2904,1,2904,162837806,256059356,0.635938
2905,4,11620,162849426,256059356,0.635983
2906,2,5812,162855238,256059356,0.636006
2907,2,5814,162861052,256059356,0.636029
2908,1,2908,162863960,256059356,0.63604
2909,1,2909,162866869,256059356,0.636051
2910,2,5820,162872689,256059356,0.636074
2911,1,2911,162875600,256059356,0.636085
2912,4,11648,162887248,256059356,0.636131
2914,1,2914,162890162,256059356,0.636142
2915,1,2915,162893077,256059356,0.636154
2916,2,5832,162898909,256059356,0.636176
2917,4,11668,162910577,256059356,0.636222
2918,4,11672,162922249,256059356,0.636268
2920,2,5840,162928089,256059356,0.63629
2922,1,2922,162931011,256059356,0.636302
2924,1,2924,162933935,256059356,0.636313
2925,1,2925,162936860,256059356,0.636325
2926,1,2926,162939786,256059356,0.636336
2928,2,5856,162945642,256059356,0.636359
2929,2,5858,162951500,256059356,0.636382
2930,2,5860,162957360,256059356,0.636405
2931,1,2931,162960291,256059356,0.636416
2932,2,5864,162966155,256059356,0.636439
2933,1,2933,162969088,256059356,0.63645
2934,1,2934,162972022,256059356,0.636462
2935,3,8805,162980827,256059356,0.636496
2938,1,2938,162983765,256059356,0.636508
2941,3,8823,162992588,256059356,0.636542
2943,2,5886,162998474,256059356,0.636565
2944,1,2944,163001418,256059356,0.636577
2945,1,2945,163004363,256059356,0.636588
2946,2,5892,163010255,256059356,0.636611
2948,1,2948,163013203,256059356,0.636623
2949,2,5898,163019101,256059356,0.636646
2953,1,2953,163022054,256059356,0.636657
2954,1,2954,163025008,256059356,0.636669
2955,2,5910,163030918,256059356,0.636692
2956,1,2956,163033874,256059356,0.636703
2957,4,11828,163045702,256059356,0.63675
2958,1,2958,163048660,256059356,0.636761
2959,1,2959,163051619,256059356,0.636773
2960,1,2960,163054579,256059356,0.636784
2962,1,2962,163057541,256059356,0.636796
2964,1,2964,163060505,256059356,0.636807
2968,4,11872,163072377,256059356,0.636854
2971,3,8913,163081290,256059356,0.636889
2972,1,2972,163084262,256059356,0.6369
2974,2,5948,163090210,256059356,0.636923
2976,2,5952,163096162,256059356,0.636947
2980,1,2980,163099142,256059356,0.636958
2982,1,2982,163102124,256059356,0.63697
2983,2,5966,163108090,256059356,0.636993
2985,1,2985,163111075,256059356,0.637005
2986,1,2986,163114061,256059356,0.637017
2987,4,11948,163126009,256059356,0.637063
2988,3,8964,163134973,256059356,0.637098
2992,2,5984,163140957,256059356,0.637122
2993,1,2993,163143950,256059356,0.637133
2994,2,5988,163149938,256059356,0.637157
2995,2,5990,163155928,256059356,0.63718
2996,2,5992,163161920,256059356,0.637204
2999,1,2999,163164919,256059356,0.637215
3001,1,3001,163167920,256059356,0.637227
3002,1,3002,163170922,256059356,0.637239
3006,1,3006,163173928,256059356,0.63725
3008,2,6016,163179944,256059356,0.637274
3009,1,3009,163182953,256059356,0.637286
3010,1,3010,163185963,256059356,0.637297
3011,1,3011,163188974,256059356,0.637309
3018,3,9054,163198028,256059356,0.637345
3020,1,3020,163201048,256059356,0.637356
3021,1,3021,163204069,256059356,0.637368
3023,1,3023,163207092,256059356,0.63738
3024,1,3024,163210116,256059356,0.637392
3026,1,3026,163213142,256059356,0.637404
3028,1,3028,163216170,256059356,0.637415
3029,1,3029,163219199,256059356,0.637427
3030,1,3030,163222229,256059356,0.637439
3031,1,3031,163225260,256059356,0.637451
3033,2,6066,163231326,256059356,0.637475
3034,1,3034,163234360,256059356,0.637486
3038,1,3038,163237398,256059356,0.637498
3039,1,3039,163240437,256059356,0.63751
3040,1,3040,163243477,256059356,0.637522
3041,2,6082,163249559,256059356,0.637546
3044,1,3044,163252603,256059356,0.637558
3046,1,3046,163255649,256059356,0.63757
3047,2,6094,163261743,256059356,0.637593
3048,2,6096,163267839,256059356,0.637617
3049,1,3049,163270888,256059356,0.637629
3051,1,3051,163273939,256059356,0.637641
3052,1,3052,163276991,256059356,0.637653
3054,1,3054,163280045,256059356,0.637665
3055,2,6110,163286155,256059356,0.637689
3057,1,3057,163289212,256059356,0.637701
3059,1,3059,163292271,256059356,0.637713
3060,2,6120,163298391,256059356,0.637736
3062,2,6124,163304515,256059356,0.63776
3063,1,3063,163307578,256059356,0.637772
3064,1,3064,163310642,256059356,0.637784
3065,1,3065,163313707,256059356,0.637796
3067,2,6134,163319841,256059356,0.63782
3068,4,12272,163332113,256059356,0.637868
3075,1,3075,163335188,256059356,0.63788
3078,1,3078,163338266,256059356,0.637892
3079,1,3079,163341345,256059356,0.637904
3080,2,6160,163347505,256059356,0.637928
3081,2,6162,163353667,256059356,0.637952
3082,1,3082,163356749,256059356,0.637964
3085,2,6170,163362919,256059356,0.637988
3087,2,6174,163369093,256059356,0.638013
3088,1,3088,163372181,256059356,0.638025
3089,2,6178,163378359,256059356,0.638049
3090,3,9270,163387629,256059356,0.638085
3091,1,3091,163390720,256059356,0.638097
3092,3,9276,163399996,256059356,0.638133
3093,1,3093,163403089,256059356,0.638145
3094,1,3094,163406183,256059356,0.638157
3096,1,3096,163409279,256059356,0.63817
3097,2,6194,163415473,256059356,0.638194
3098,4,12392,163427865,256059356,0.638242
3099,2,6198,163434063,256059356,0.638266
3101,1,3101,163437164,256059356,0.638278
3103,1,3103,163440267,256059356,0.638291
3107,3,9321,163449588,256059356,0.638327
3108,1,3108,163452696,256059356,0.638339
3110,1,3110,163455806,256059356,0.638351
3111,2,6222,163462028,256059356,0.638376
3112,1,3112,163465140,256059356,0.638388
3113,1,3113,163468253,256059356,0.6384
3115,1,3115,163471368,256059356,0.638412
3116,1,3116,163474484,256059356,0.638424
3118,3,9354,163483838,256059356,0.638461
3120,2,6240,163490078,256059356,0.638485
3121,1,3121,163493199,256059356,0.638497
3122,1,3122,163496321,256059356,0.638509
3123,2,6246,163502567,256059356,0.638534
3124,3,9372,163511939,256059356,0.63857
3125,1,3125,163515064,256059356,0.638583
3126,1,3126,163518190,256059356,0.638595
3127,2,6254,163524444,256059356,0.638619
3128,1,3128,163527572,256059356,0.638632
3129,2,6258,163533830,256059356,0.638656
3130,1,3130,163536960,256059356,0.638668
3133,1,3133,163540093,256059356,0.63868
3136,2,6272,163546365,256059356,0.638705
3137,1,3137,163549502,256059356,0.638717
3139,1,3139,163552641,256059356,0.638729
3140,1,3140,163555781,256059356,0.638742
3142,2,6284,163562065,256059356,0.638766
3143,1,3143,163565208,256059356,0.638778
3144,1,3144,163568352,256059356,0.638791
3147,1,3147,163571499,256059356,0.638803
3148,1,3148,163574647,256059356,0.638815
3149,1,3149,163577796,256059356,0.638828
3150,3,9450,163587246,256059356,0.638865
3151,1,3151,163590397,256059356,0.638877
3152,3,9456,163599853,256059356,0.638914
3154,1,3154,163603007,256059356,0.638926
3155,2,6310,163609317,256059356,0.638951
3157,1,3157,163612474,256059356,0.638963
3158,1,3158,163615632,256059356,0.638975
3160,1,3160,163618792,256059356,0.638988
3161,2,6322,163625114,256059356,0.639012
3163,1,3163,163628277,256059356,0.639025
3164,2,6328,163634605,256059356,0.63905
3167,3,9501,163644106,256059356,0.639087
3169,3,9507,163653613,256059356,0.639124
3170,2,6340,163659953,256059356,0.639148
3172,1,3172,163663125,256059356,0.639161
3173,1,3173,163666298,256059356,0.639173
3176,1,3176,163669474,256059356,0.639186
3179,1,3179,163672653,256059356,0.639198
3180,1,3180,163675833,256059356,0.639211
3181,1,3181,163679014,256059356,0.639223
3182,2,6364,163685378,256059356,0.639248
3184,1,3184,163688562,256059356,0.63926
3185,1,3185,163691747,256059356,0.639273
3187,4,12748,163704495,256059356,0.639322
3188,2,6376,163710871,256059356,0.639347
3189,1,3189,163714060,256059356,0.63936
3190,3,9570,163723630,256059356,0.639397
3192,2,6384,163730014,256059356,0.639422
3193,1,3193,163733207,256059356,0.639435
3195,2,6390,163739597,256059356,0.63946
3196,2,6392,163745989,256059356,0.639484
3197,2,6394,163752383,256059356,0.639509
3198,1,3198,163755581,256059356,0.639522
3200,2,6400,163761981,256059356,0.639547
3203,1,3203,163765184,256059356,0.639559
3204,2,6408,163771592,256059356,0.639584
3205,1,3205,163774797,256059356,0.639597
3206,3,9618,163784415,256059356,0.639635
3207,1,3207,163787622,256059356,0.639647
3208,3,9624,163797246,256059356,0.639685
3210,2,6420,163803666,256059356,0.63971
3211,2,6422,163810088,256059356,0.639735
3212,2,6424,163816512,256059356,0.63976
3214,2,6428,163822940,256059356,0.639785
3216,3,9648,163832588,256059356,0.639823
3218,1,3218,163835806,256059356,0.639835
3220,1,3220,163839026,256059356,0.639848
3222,1,3222,163842248,256059356,0.63986
3223,2,6446,163848694,256059356,0.639886
3224,1,3224,163851918,256059356,0.639898
3225,1,3225,163855143,256059356,0.639911
3227,1,3227,163858370,256059356,0.639923
3229,3,9687,163868057,256059356,0.639961
3230,2,6460,163874517,256059356,0.639986
3231,1,3231,163877748,256059356,0.639999
3233,2,6466,163884214,256059356,0.640024
3234,1,3234,163887448,256059356,0.640037
3235,1,3235,163890683,256059356,0.64005
3236,1,3236,163893919,256059356,0.640062
3237,1,3237,163897156,256059356,0.640075
3238,1,3238,163900394,256059356,0.640088
3239,3,9717,163910111,256059356,0.640125
3241,3,9723,163919834,256059356,0.640163
3242,3,9726,163929560,256059356,0.640201
3243,1,3243,163932803,256059356,0.640214
3244,1,3244,163936047,256059356,0.640227
3245,1,3245,163939292,256059356,0.640239
3246,1,3246,163942538,256059356,0.640252
3250,1,3250,163945788,256059356,0.640265
3251,1,3251,163949039,256059356,0.640277
3252,1,3252,163952291,256059356,0.64029
3255,2,6510,163958801,256059356,0.640316
3256,1,3256,163962057,256059356,0.640328
3257,2,6514,163968571,256059356,0.640354
3259,3,9777,163978348,256059356,0.640392
3260,3,9780,163988128,256059356,0.64043
3261,2,6522,163994650,256059356,0.640456
3262,2,6524,164001174,256059356,0.640481
3263,3,9789,164010963,256059356,0.640519
3265,1,3265,164014228,256059356,0.640532
3266,2,6532,164020760,256059356,0.640558
3267,1,3267,164024027,256059356,0.64057
3268,1,3268,164027295,256059356,0.640583
3269,1,3269,164030564,256059356,0.640596
3270,1,3270,164033834,256059356,0.640609
3273,4,13092,164046926,256059356,0.64066
3277,1,3277,164050203,256059356,0.640673
3278,1,3278,164053481,256059356,0.640685
3280,3,9840,164063321,256059356,0.640724
3281,2,6562,164069883,256059356,0.640749
3287,1,3287,164073170,256059356,0.640762
3288,1,3288,164076458,256059356,0.640775
3290,1,3290,164079748,256059356,0.640788
3291,1,3291,164083039,256059356,0.640801
3293,1,3293,164086332,256059356,0.640814
3295,1,3295,164089627,256059356,0.640827
3297,1,3297,164092924,256059356,0.640839
3300,1,3300,164096224,256059356,0.640852
3301,2,6602,164102826,256059356,0.640878
3303,1,3303,164106129,256059356,0.640891
3305,2,6610,164112739,256059356,0.640917
3306,1,3306,164116045,256059356,0.64093
3307,1,3307,164119352,256059356,0.640943
3309,1,3309,164122661,256059356,0.640956
3311,1,3311,164125972,256059356,0.640968
3312,1,3312,164129284,256059356,0.640981
3313,2,6626,164135910,256059356,0.641007
3315,2,6630,164142540,256059356,0.641033
3316,3,9948,164152488,256059356,0.641072
3317,2,6634,164159122,256059356,0.641098
3318,1,3318,164162440,256059356,0.641111
3319,2,6638,164169078,256059356,0.641137
3323,1,3323,164172401,256059356,0.64115
3326,2,6652,164179053,256059356,0.641176
3328,1,3328,164182381,256059356,0.641189
3331,2,6662,164189043,256059356,0.641215
3334,4,13336,164202379,256059356,0.641267
3335,1,3335,164205714,256059356,0.64128
3336,1,3336,164209050,256059356,0.641293
3337,1,3337,164212387,256059356,0.641306
3338,1,3338,164215725,256059356,0.641319
3341,1,3341,164219066,256059356,0.641332
3342,2,6684,164225750,256059356,0.641358
3343,1,3343,164229093,256059356,0.641371
3344,1,3344,164232437,256059356,0.641384
3346,1,3346,164235783,256059356,0.641397
3347,2,6694,164242477,256059356,0.641423
3348,1,3348,164245825,256059356,0.641437
3355,4,13420,164259245,256059356,0.641489
3357,3,10071,164269316,256059356,0.641528
3359,2,6718,164276034,256059356,0.641555
3360,2,6720,164282754,256059356,0.641581
3361,3,10083,164292837,256059356,0.64162
3362,1,3362,164296199,256059356,0.641633
3363,2,6726,164302925,256059356,0.64166
3365,3,10095,164313020,256059356,0.641699
3366,1,3366,164316386,256059356,0.641712
3368,2,6736,164323122,256059356,0.641738
3369,1,3369,164326491,256059356,0.641752
3370,1,3370,164329861,256059356,0.641765
3371,3,10113,164339974,256059356,0.641804
3372,1,3372,164343346,256059356,0.641817
3374,3,10122,164353468,256059356,0.641857
3375,1,3375,164356843,256059356,0.64187
3378,1,3378,164360221,256059356,0.641883
3381,1,3381,164363602,256059356,0.641896
3382,2,6764,164370366,256059356,0.641923
3383,2,6766,164377132,256059356,0.641949
3384,1,3384,164380516,256059356,0.641963
3385,2,6770,164387286,256059356,0.641989
3386,1,3386,164390672,256059356,0.642002
3387,1,3387,164394059,256059356,0.642015
3389,4,13556,164407615,256059356,0.642068
3390,5,16950,164424565,256059356,0.642135
3391,1,3391,164427956,256059356,0.642148
3393,2,6786,164434742,256059356,0.642174
3394,1,3394,164438136,256059356,0.642188
3395,1,3395,164441531,256059356,0.642201
3397,1,3397,164444928,256059356,0.642214
3400,4,13600,164458528,256059356,0.642267
3402,1,3402,164461930,256059356,0.64228
3403,2,6806,164468736,256059356,0.642307
3404,1,3404,164472140,256059356,0.64232
3408,1,3408,164475548,256059356,0.642334
3411,1,3411,164478959,256059356,0.642347
3412,2,6824,164485783,256059356,0.642374
3414,1,3414,164489197,256059356,0.642387
3419,2,6838,164496035,256059356,0.642414
3420,1,3420,164499455,256059356,0.642427
3422,1,3422,164502877,256059356,0.64244
3424,1,3424,164506301,256059356,0.642454
3427,1,3427,164509728,256059356,0.642467
3428,1,3428,164513156,256059356,0.642481
3431,1,3431,164516587,256059356,0.642494
3432,2,6864,164523451,256059356,0.642521
3433,1,3433,164526884,256059356,0.642534
3435,1,3435,164530319,256059356,0.642548
3436,1,3436,164533755,256059356,0.642561
3437,2,6874,164540629,256059356,0.642588
3438,1,3438,164544067,256059356,0.642601
3439,1,3439,164547506,256059356,0.642615
3440,1,3440,164550946,256059356,0.642628
3441,1,3441,164554387,256059356,0.642642
3444,1,3444,164557831,256059356,0.642655
3445,2,6890,164564721,256059356,0.642682
3447,1,3447,164568168,256059356,0.642695
3448,1,3448,164571616,256059356,0.642709
3451,1,3451,164575067,256059356,0.642722
3452,2,6904,164581971,256059356,0.642749
3453,2,6906,164588877,256059356,0.642776
3454,1,3454,164592331,256059356,0.64279
3455,1,3455,164595786,256059356,0.642803
3456,2,6912,164602698,256059356,0.64283
3457,1,3457,164606155,256059356,0.642844
3458,1,3458,164609613,256059356,0.642857
3461,1,3461,164613074,256059356,0.642871
3464,1,3464,164616538,256059356,0.642884
3466,1,3466,164620004,256059356,0.642898
3469,1,3469,164623473,256059356,0.642911
3472,1,3472,164626945,256059356,0.642925
3478,1,3478,164630423,256059356,0.642939
3479,1,3479,164633902,256059356,0.642952
3481,2,6962,164640864,256059356,0.642979
3483,1,3483,164644347,256059356,0.642993
3484,1,3484,164647831,256059356,0.643007
3485,1,3485,164651316,256059356,0.64302
3486,1,3486,164654802,256059356,0.643034
3490,1,3490,164658292,256059356,0.643047
3497,1,3497,164661789,256059356,0.643061
3498,1,3498,164665287,256059356,0.643075
3499,1,3499,164668786,256059356,0.643088
3502,1,3502,164672288,256059356,0.643102
3507,1,3507,164675795,256059356,0.643116
3511,1,3511,164679306,256059356,0.643129
3513,1,3513,164682819,256059356,0.643143
3514,1,3514,164686333,256059356,0.643157
3515,1,3515,164689848,256059356,0.643171
3516,1,3516,164693364,256059356,0.643184
3518,1,3518,164696882,256059356,0.643198
3520,1,3520,164700402,256059356,0.643212
3522,3,10566,164710968,256059356,0.643253
3523,2,7046,164718014,256059356,0.643281
3524,1,3524,164721538,256059356,0.643294
3526,1,3526,164725064,256059356,0.643308
3528,1,3528,164728592,256059356,0.643322
3529,1,3529,164732121,256059356,0.643336
3530,1,3530,164735651,256059356,0.643349
3531,2,7062,164742713,256059356,0.643377
3532,2,7064,164749777,256059356,0.643405
3533,1,3533,164753310,256059356,0.643418
3534,2,7068,164760378,256059356,0.643446
3535,3,10605,164770983,256059356,0.643487
3536,1,3536,164774519,256059356,0.643501
3537,1,3537,164778056,256059356,0.643515
3538,1,3538,164781594,256059356,0.643529
3542,1,3542,164785136,256059356,0.643543
3543,4,14172,164799308,256059356,0.643598
3545,3,10635,164809943,256059356,0.64364
3546,1,3546,164813489,256059356,0.643653
3547,1,3547,164817036,256059356,0.643667
3548,5,17740,164834776,256059356,0.643737
3550,1,3550,164838326,256059356,0.64375
3551,2,7102,164845428,256059356,0.643778
3552,1,3552,164848980,256059356,0.643792
3553,1,3553,164852533,256059356,0.643806
3555,1,3555,164856088,256059356,0.64382
3556,1,3556,164859644,256059356,0.643834
3558,2,7116,164866760,256059356,0.643861
3559,1,3559,164870319,256059356,0.643875
3561,1,3561,164873880,256059356,0.643889
3563,1,3563,164877443,256059356,0.643903
3564,1,3564,164881007,256059356,0.643917
3565,2,7130,164888137,256059356,0.643945
3566,2,7132,164895269,256059356,0.643973
3567,2,7134,164902403,256059356,0.644001
3568,1,3568,164905971,256059356,0.644015
3571,1,3571,164909542,256059356,0.644029
3572,1,3572,164913114,256059356,0.644043
3574,1,3574,164916688,256059356,0.644056
3575,2,7150,164923838,256059356,0.644084
3578,1,3578,164927416,256059356,0.644098
3581,2,7162,164934578,256059356,0.644126
3582,1,3582,164938160,256059356,0.64414
3583,1,3583,164941743,256059356,0.644154
3588,3,10764,164952507,256059356,0.644196
3590,1,3590,164956097,256059356,0.64421
3594,3,10782,164966879,256059356,0.644252
3595,1,3595,164970474,256059356,0.644267
3598,1,3598,164974072,256059356,0.644281
3599,1,3599,164977671,256059356,0.644295
3600,1,3600,164981271,256059356,0.644309
3601,2,7202,164988473,256059356,0.644337
3606,1,3606,164992079,256059356,0.644351
3607,2,7214,164999293,256059356,0.644379
3608,1,3608,165002901,256059356,0.644393
3609,1,3609,165006510,256059356,0.644407
3611,1,3611,165010121,256059356,0.644421
3612,1,3612,165013733,256059356,0.644435
3615,3,10845,165024578,256059356,0.644478
3616,2,7232,165031810,256059356,0.644506
3618,2,7236,165039046,256059356,0.644534
3620,2,7240,165046286,256059356,0.644563
3621,1,3621,165049907,256059356,0.644577
3622,1,3622,165053529,256059356,0.644591
3623,2,7246,165060775,256059356,0.644619
3625,2,7250,165068025,256059356,0.644648
3626,1,3626,165071651,256059356,0.644662
3627,1,3627,165075278,256059356,0.644676
3628,1,3628,165078906,256059356,0.64469
3631,1,3631,165082537,256059356,0.644704
3632,1,3632,165086169,256059356,0.644718
3633,1,3633,165089802,256059356,0.644733
3638,2,7276,165097078,256059356,0.644761
3640,1,3640,165100718,256059356,0.644775
3642,1,3642,165104360,256059356,0.644789
3643,1,3643,165108003,256059356,0.644804
3644,3,10932,165118935,256059356,0.644846
3645,2,7290,165126225,256059356,0.644875
3646,1,3646,165129871,256059356,0.644889
3647,3,10941,165140812,256059356,0.644932
3648,3,10944,165151756,256059356,0.644975
3651,1,3651,165155407,256059356,0.644989
3652,1,3652,165159059,256059356,0.645003
3653,2,7306,165166365,256059356,0.645032
3654,1,3654,165170019,256059356,0.645046
3656,3,10968,165180987,256059356,0.645089
3659,1,3659,165184646,256059356,0.645103
3662,2,7324,165191970,256059356,0.645132
3667,1,3667,165195637,256059356,0.645146
3668,2,7336,165202973,256059356,0.645175
3669,1,3669,165206642,256059356,0.645189
3670,1,3670,165210312,256059356,0.645203
3671,1,3671,165213983,256059356,0.645218
3672,1,3672,165217655,256059356,0.645232
3673,2,7346,165225001,256059356,0.645261
3674,3,11022,165236023,256059356,0.645304
3675,1,3675,165239698,256059356,0.645318
3680,2,7360,165247058,256059356,0.645347
3684,2,7368,165254426,256059356,0.645375
3685,2,7370,165261796,256059356,0.645404
3695,1,3695,165265491,256059356,0.645419
3697,2,7394,165272885,256059356,0.645448
3701,2,7402,165280287,256059356,0.645476
3702,2,7404,165287691,256059356,0.645505
3703,3,11109,165298800,256059356,0.645549
3704,2,7408,165306208,256059356,0.645578
3705,1,3705,165309913,256059356,0.645592
3706,1,3706,165313619,256059356,0.645607
3707,2,7414,165321033,256059356,0.645636
3708,1,3708,165324741,256059356,0.64565
3709,3,11127,165335868,256059356,0.645694
3710,3,11130,165346998,256059356,0.645737
3711,1,3711,165350709,256059356,0.645751
3712,1,3712,165354421,256059356,0.645766
3714,2,7428,165361849,256059356,0.645795
3715,2,7430,165369279,256059356,0.645824
3717,1,3717,165372996,256059356,0.645839
3718,1,3718,165376714,256059356,0.645853
3719,1,3719,165380433,256059356,0.645868
3720,3,11160,165391593,256059356,0.645911
3722,1,3722,165395315,256059356,0.645926
3726,1,3726,165399041,256059356,0.64594
3727,1,3727,165402768,256059356,0.645955
3732,1,3732,165406500,256059356,0.645969
3734,1,3734,165410234,256059356,0.645984
3737,1,3737,165413971,256059356,0.645999
3740,1,3740,165417711,256059356,0.646013
3741,2,7482,165425193,256059356,0.646042
3743,1,3743,165428936,256059356,0.646057
3744,3,11232,165440168,256059356,0.646101
3745,1,3745,165443913,256059356,0.646115
3748,1,3748,165447661,256059356,0.64613
3750,2,7500,165455161,256059356,0.646159
3751,1,3751,165458912,256059356,0.646174
3752,2,7504,165466416,256059356,0.646203
3753,2,7506,165473922,256059356,0.646233
3756,1,3756,165477678,256059356,0.646247
3757,1,3757,165481435,256059356,0.646262
3759,1,3759,165485194,256059356,0.646277
3761,1,3761,165488955,256059356,0.646291
3765,1,3765,165492720,256059356,0.646306
3768,1,3768,165496488,256059356,0.646321
3770,1,3770,165500258,256059356,0.646336
3771,1,3771,165504029,256059356,0.64635
3773,2,7546,165511575,256059356,0.64638
3774,1,3774,165515349,256059356,0.646394
3775,4,15100,165530449,256059356,0.646453
3776,2,7552,165538001,256059356,0.646483
3778,2,7556,165545557,256059356,0.646512
3780,3,11340,165556897,256059356,0.646557
3781,2,7562,165564459,256059356,0.646586
3782,1,3782,165568241,256059356,0.646601
3783,1,3783,165572024,256059356,0.646616
3785,1,3785,165575809,256059356,0.646631
3786,1,3786,165579595,256059356,0.646645
3788,1,3788,165583383,256059356,0.64666
3790,1,3790,165587173,256059356,0.646675
3792,4,15168,165602341,256059356,0.646734
3794,1,3794,165606135,256059356,0.646749
3795,1,3795,165609930,256059356,0.646764
3796,1,3796,165613726,256059356,0.646779
3797,1,3797,165617523,256059356,0.646793
3799,2,7598,165625121,256059356,0.646823
3801,1,3801,165628922,256059356,0.646838
3802,1,3802,165632724,256059356,0.646853
3803,1,3803,165636527,256059356,0.646868
3805,2,7610,165644137,256059356,0.646897
3806,2,7612,165651749,256059356,0.646927
3807,1,3807,165655556,256059356,0.646942
3810,1,3810,165659366,256059356,0.646957
3812,1,3812,165663178,256059356,0.646972
3813,2,7626,165670804,256059356,0.647002
3814,1,3814,165674618,256059356,0.647016
3815,1,3815,165678433,256059356,0.647031
3816,1,3816,165682249,256059356,0.647046
3817,2,7634,165689883,256059356,0.647076
3818,4,15272,165705155,256059356,0.647136
3826,2,7652,165712807,256059356,0.647166
3828,2,7656,165720463,256059356,0.647196
3830,1,3830,165724293,256059356,0.64721
3831,1,3831,165728124,256059356,0.647225
3834,2,7668,165735792,256059356,0.647255
3836,1,3836,165739628,256059356,0.64727
3838,3,11514,165751142,256059356,0.647315
3839,1,3839,165754981,256059356,0.64733
3842,2,7684,165762665,256059356,0.64736
3849,2,7698,165770363,256059356,0.64739
3852,1,3852,165774215,256059356,0.647405
3854,5,19270,165793485,256059356,0.647481
3856,2,7712,165801197,256059356,0.647511
3857,1,3857,165805054,256059356,0.647526
3858,1,3858,165808912,256059356,0.647541
3860,1,3860,165812772,256059356,0.647556
3861,1,3861,165816633,256059356,0.647571
3862,1,3862,165820495,256059356,0.647586
3863,1,3863,165824358,256059356,0.647601
3865,1,3865,165828223,256059356,0.647616
3868,1,3868,165832091,256059356,0.647631
3872,1,3872,165835963,256059356,0.647647
3875,1,3875,165839838,256059356,0.647662
3877,2,7754,165847592,256059356,0.647692
3879,1,3879,165851471,256059356,0.647707
3880,1,3880,165855351,256059356,0.647722
3887,1,3887,165859238,256059356,0.647737
3889,1,3889,165863127,256059356,0.647753
3893,1,3893,165867020,256059356,0.647768
3894,1,3894,165870914,256059356,0.647783
3895,3,11685,165882599,256059356,0.647829
3897,1,3897,165886496,256059356,0.647844
3899,1,3899,165890395,256059356,0.647859
3900,1,3900,165894295,256059356,0.647874
3902,1,3902,165898197,256059356,0.64789
3903,1,3903,165902100,256059356,0.647905
3904,2,7808,165909908,256059356,0.647935
3907,2,7814,165917722,256059356,0.647966
3909,1,3909,165921631,256059356,0.647981
3911,1,3911,165925542,256059356,0.647996
3912,1,3912,165929454,256059356,0.648012
3914,1,3914,165933368,256059356,0.648027
3915,1,3915,165937283,256059356,0.648042
3918,1,3918,165941201,256059356,0.648058
3920,1,3920,165945121,256059356,0.648073
3922,1,3922,165949043,256059356,0.648088
3924,2,7848,165956891,256059356,0.648119
3925,1,3925,165960816,256059356,0.648134
3926,1,3926,165964742,256059356,0.648149
3929,1,3929,165968671,256059356,0.648165
3932,2,7864,165976535,256059356,0.648196
3935,1,3935,165980470,256059356,0.648211
3938,1,3938,165984408,256059356,0.648226
3941,2,7882,165992290,256059356,0.648257
3945,1,3945,165996235,256059356,0.648272
3946,1,3946,166000181,256059356,0.648288
3947,1,3947,166004128,256059356,0.648303
3949,1,3949,166008077,256059356,0.648319
3951,1,3951,166012028,256059356,0.648334
3955,1,3955,166015983,256059356,0.64835
3960,3,11880,166027863,256059356,0.648396
3966,2,7932,166035795,256059356,0.648427
3968,1,3968,166039763,256059356,0.648442
3972,1,3972,166043735,256059356,0.648458
3973,2,7946,166051681,256059356,0.648489
3974,1,3974,166055655,256059356,0.648505
3977,1,3977,166059632,256059356,0.64852
3983,1,3983,166063615,256059356,0.648536
3985,1,3985,166067600,256059356,0.648551
3987,1,3987,166071587,256059356,0.648567
3988,1,3988,166075575,256059356,0.648582
3992,1,3992,166079567,256059356,0.648598
3993,2,7986,166087553,256059356,0.648629
3997,1,3997,166091550,256059356,0.648645
3998,2,7996,166099546,256059356,0.648676
3999,1,3999,166103545,256059356,0.648692
4000,1,4000,166107545,256059356,0.648707
4001,1,4001,166111546,256059356,0.648723
4002,1,4002,166115548,256059356,0.648738
4003,1,4003,166119551,256059356,0.648754
4005,1,4005,166123556,256059356,0.64877
4006,4,16024,166139580,256059356,0.648832
4008,1,4008,166143588,256059356,0.648848
4009,2,8018,166151606,256059356,0.648879
4010,1,4010,166155616,256059356,0.648895
4012,1,4012,166159628,256059356,0.648911
4013,1,4013,166163641,256059356,0.648926
4014,2,8028,166171669,256059356,0.648958
4018,2,8036,166179705,256059356,0.648989
4026,1,4026,166183731,256059356,0.649005
4027,1,4027,166187758,256059356,0.64902
4028,1,4028,166191786,256059356,0.649036
4029,3,12087,166203873,256059356,0.649083
4031,1,4031,166207904,256059356,0.649099
4032,1,4032,166211936,256059356,0.649115
4034,1,4034,166215970,256059356,0.649131
4036,1,4036,166220006,256059356,0.649146
4037,1,4037,166224043,256059356,0.649162
4040,2,8080,166232123,256059356,0.649194
4041,1,4041,166236164,256059356,0.649209
4044,1,4044,166240208,256059356,0.649225
4046,1,4046,166244254,256059356,0.649241
4047,1,4047,166248301,256059356,0.649257
4050,1,4050,166252351,256059356,0.649273
4051,1,4051,166256402,256059356,0.649289
4059,2,8118,166264520,256059356,0.64932
4063,1,4063,166268583,256059356,0.649336
4066,2,8132,166276715,256059356,0.649368
4067,1,4067,166280782,256059356,0.649384
4068,2,8136,166288918,256059356,0.649416
4069,1,4069,166292987,256059356,0.649431
4070,1,4070,166297057,256059356,0.649447
4074,1,4074,166301131,256059356,0.649463
4075,1,4075,166305206,256059356,0.649479
4076,2,8152,166313358,256059356,0.649511
4077,1,4077,166317435,256059356,0.649527
4079,1,4079,166321514,256059356,0.649543
4080,3,12240,166333754,256059356,0.649591
4081,3,12243,166345997,256059356,0.649638
4083,1,4083,166350080,256059356,0.649654
4085,1,4085,166354165,256059356,0.64967
4086,1,4086,166358251,256059356,0.649686
4087,1,4087,166362338,256059356,0.649702
4089,1,4089,166366427,256059356,0.649718
4093,1,4093,166370520,256059356,0.649734
4094,1,4094,166374614,256059356,0.64975
4098,1,4098,166378712,256059356,0.649766
4099,2,8198,166386910,256059356,0.649798
4102,1,4102,166391012,256059356,0.649814
4107,1,4107,166395119,256059356,0.64983
4109,2,8218,166403337,256059356,0.649862
4110,3,12330,166415667,256059356,0.649911
4115,1,4115,166419782,256059356,0.649927
4116,2,8232,166428014,256059356,0.649959
4118,2,8236,166436250,256059356,0.649991
4120,1,4120,166440370,256059356,0.650007
4123,1,4123,166444493,256059356,0.650023
4126,1,4126,166448619,256059356,0.650039
4127,1,4127,166452746,256059356,0.650055
4129,1,4129,166456875,256059356,0.650071
4131,1,4131,166461006,256059356,0.650088
4132,1,4132,166465138,256059356,0.650104
4138,1,4138,166469276,256059356,0.65012
4141,1,4141,166473417,256059356,0.650136
4142,2,8284,166481701,256059356,0.650168
4143,3,12429,166494130,256059356,0.650217
4144,1,4144,166498274,256059356,0.650233
4145,2,8290,166506564,256059356,0.650265
4146,2,8292,166514856,256059356,0.650298
4148,3,12444,166527300,256059356,0.650346
4152,1,4152,166531452,256059356,0.650363
4153,1,4153,166535605,256059356,0.650379
4154,1,4154,166539759,256059356,0.650395
4159,2,8318,166548077,256059356,0.650428
4161,1,4161,166552238,256059356,0.650444
4162,1,4162,166556400,256059356,0.65046
4164,1,4164,166560564,256059356,0.650476
4166,1,4166,166564730,256059356,0.650493
4171,1,4171,166568901,256059356,0.650509
4173,2,8346,166577247,256059356,0.650542
4174,1,4174,166581421,256059356,0.650558
4175,2,8350,166589771,256059356,0.65059
4180,1,4180,166593951,256059356,0.650607
4182,2,8364,166602315,256059356,0.650639
4183,1,4183,166606498,256059356,0.650656
4192,1,4192,166610690,256059356,0.650672
4195,2,8390,166619080,256059356,0.650705
4198,1,4198,166623278,256059356,0.650721
4199,1,4199,166627477,256059356,0.650738
4202,1,4202,166631679,256059356,0.650754
4205,1,4205,166635884,256059356,0.650771
4208,1,4208,166640092,256059356,0.650787
4209,2,8418,166648510,256059356,0.65082
4210,1,4210,166652720,256059356,0.650836
4211,1,4211,166656931,256059356,0.650853
4214,1,4214,166661145,256059356,0.650869
4217,2,8434,166669579,256059356,0.650902
4220,1,4220,166673799,256059356,0.650919
4226,1,4226,166678025,256059356,0.650935
4227,2,8454,166686479,256059356,0.650968
4232,1,4232,166690711,256059356,0.650985
4235,1,4235,166694946,256059356,0.651001
4236,2,8472,166703418,256059356,0.651034
4237,1,4237,166707655,256059356,0.651051
4240,1,4240,166711895,256059356,0.651067
4242,2,8484,166720379,256059356,0.651101
4243,2,8486,166728865,256059356,0.651134
4244,1,4244,166733109,256059356,0.65115
4245,1,4245,166737354,256059356,0.651167
4247,2,8494,166745848,256059356,0.6512
4251,2,8502,166754350,256059356,0.651233
4252,1,4252,166758602,256059356,0.65125
4256,2,8512,166767114,256059356,0.651283
4259,1,4259,166771373,256059356,0.6513
4260,1,4260,166775633,256059356,0.651316
4265,2,8530,166784163,256059356,0.65135
4269,3,12807,166796970,256059356,0.6514
4271,1,4271,166801241,256059356,0.651416
4272,1,4272,166805513,256059356,0.651433
4274,1,4274,166809787,256059356,0.65145
4279,1,4279,166814066,256059356,0.651466
4282,1,4282,166818348,256059356,0.651483
4283,1,4283,166822631,256059356,0.6515
4284,2,8568,166831199,256059356,0.651533
4285,1,4285,166835484,256059356,0.65155
4286,1,4286,166839770,256059356,0.651567
4291,1,4291,166844061,256059356,0.651584
4292,1,4292,166848353,256059356,0.6516
4297,1,4297,166852650,256059356,0.651617
4299,2,8598,166861248,256059356,0.651651
4300,1,4300,166865548,256059356,0.651667
4301,1,4301,166869849,256059356,0.651684
4303,3,12909,166882758,256059356,0.651735
4308,1,4308,166887066,256059356,0.651751
4309,1,4309,166891375,256059356,0.651768
4311,3,12933,166904308,256059356,0.651819
4313,3,12939,166917247,256059356,0.651869
4315,1,4315,166921562,256059356,0.651886
4317,1,4317,166925879,256059356,0.651903
4318,2,8636,166934515,256059356,0.651937
4319,1,4319,166938834,256059356,0.651954
4320,1,4320,166943154,256059356,0.651971
4321,1,4321,166947475,256059356,0.651987
4322,1,4322,166951797,256059356,0.652004
4323,1,4323,166956120,256059356,0.652021
4325,1,4325,166960445,256059356,0.652038
4326,1,4326,166964771,256059356,0.652055
4327,1,4327,166969098,256059356,0.652072
4328,2,8656,166977754,256059356,0.652106
4334,1,4334,166982088,256059356,0.652123
4335,1,4335,166986423,256059356,0.65214
4340,2,8680,166995103,256059356,0.652173
4341,1,4341,166999444,256059356,0.65219
4347,3,13041,167012485,256059356,0.652241
4350,3,13050,167025535,256059356,0.652292
4353,1,4353,167029888,256059356,0.652309
4354,1,4354,167034242,256059356,0.652326
4356,1,4356,167038598,256059356,0.652343
4361,1,4361,167042959,256059356,0.65236
4368,1,4368,167047327,256059356,0.652377
4369,1,4369,167051696,256059356,0.652394
4371,1,4371,167056067,256059356,0.652411
4372,1,4372,167060439,256059356,0.652429
4373,2,8746,167069185,256059356,0.652463
4374,1,4374,167073559,256059356,0.65248
4378,1,4378,167077937,256059356,0.652497
4379,1,4379,167082316,256059356,0.652514
4381,1,4381,167086697,256059356,0.652531
4382,2,8764,167095461,256059356,0.652565
4383,2,8766,167104227,256059356,0.6526
4384,1,4384,167108611,256059356,0.652617
4389,1,4389,167113000,256059356,0.652634
4391,2,8782,167121782,256059356,0.652668
4396,1,4396,167126178,256059356,0.652685
4398,2,8796,167134974,256059356,0.65272
4400,1,4400,167139374,256059356,0.652737
4401,1,4401,167143775,256059356,0.652754
4403,1,4403,167148178,256059356,0.652771
4404,1,4404,167152582,256059356,0.652788
4406,1,4406,167156988,256059356,0.652806
4407,1,4407,167161395,256059356,0.652823
4408,1,4408,167165803,256059356,0.65284
4412,1,4412,167170215,256059356,0.652857
4414,3,13242,167183457,256059356,0.652909
4415,1,4415,167187872,256059356,0.652926
4417,1,4417,167192289,256059356,0.652943
4420,2,8840,167201129,256059356,0.652978
4429,1,4429,167205558,256059356,0.652995
4430,1,4430,167209988,256059356,0.653013
4431,1,4431,167214419,256059356,0.65303
4432,1,4432,167218851,256059356,0.653047
4437,3,13311,167232162,256059356,0.653099
4438,2,8876,167241038,256059356,0.653134
4439,1,4439,167245477,256059356,0.653151
4440,2,8880,167254357,256059356,0.653186
4442,1,4442,167258799,256059356,0.653203
4445,2,8890,167267689,256059356,0.653238
4446,1,4446,167272135,256059356,0.653255
4447,2,8894,167281029,256059356,0.65329
4448,1,4448,167285477,256059356,0.653307
4449,1,4449,167289926,256059356,0.653325
4450,2,8900,167298826,256059356,0.65336
4452,2,8904,167307730,256059356,0.653394
4454,1,4454,167312184,256059356,0.653412
4455,1,4455,167316639,256059356,0.653429
4457,1,4457,167321096,256059356,0.653447
4459,1,4459,167325555,256059356,0.653464
4460,1,4460,167330015,256059356,0.653481
4462,1,4462,167334477,256059356,0.653499
4463,1,4463,167338940,256059356,0.653516
4472,1,4472,167343412,256059356,0.653534
4475,1,4475,167347887,256059356,0.653551
4476,2,8952,167356839,256059356,0.653586
4481,1,4481,167361320,256059356,0.653604
4483,3,13449,167374769,256059356,0.653656
4484,1,4484,167379253,256059356,0.653674
4485,2,8970,167388223,256059356,0.653709
4487,3,13461,167401684,256059356,0.653761
4491,1,4491,167406175,256059356,0.653779
4492,1,4492,167410667,256059356,0.653796
4494,3,13482,167424149,256059356,0.653849
4496,1,4496,167428645,256059356,0.653867
4497,1,4497,167433142,256059356,0.653884
4499,1,4499,167437641,256059356,0.653902
4500,1,4500,167442141,256059356,0.653919
4502,1,4502,167446643,256059356,0.653937
4504,2,9008,167455651,256059356,0.653972
4505,1,4505,167460156,256059356,0.65399
4509,1,4509,167464665,256059356,0.654007
4512,1,4512,167469177,256059356,0.654025
4513,3,13539,167482716,256059356,0.654078
4514,2,9028,167491744,256059356,0.654113
4519,1,4519,167496263,256059356,0.654131
4520,1,4520,167500783,256059356,0.654148
4521,1,4521,167505304,256059356,0.654166
4523,1,4523,167509827,256059356,0.654184
4525,2,9050,167518877,256059356,0.654219
4527,1,4527,167523404,256059356,0.654237
4530,1,4530,167527934,256059356,0.654254
4534,1,4534,167532468,256059356,0.654272
4535,1,4535,167537003,256059356,0.65429
4536,1,4536,167541539,256059356,0.654307
4537,1,4537,167546076,256059356,0.654325
4538,2,9076,167555152,256059356,0.654361
4541,1,4541,167559693,256059356,0.654378
4543,1,4543,167564236,256059356,0.654396
4547,1,4547,167568783,256059356,0.654414
4549,1,4549,167573332,256059356,0.654432
4551,1,4551,167577883,256059356,0.654449
4554,2,9108,167586991,256059356,0.654485
4558,1,4558,167591549,256059356,0.654503
4560,1,4560,167596109,256059356,0.654521
4563,1,4563,167600672,256059356,0.654538
4564,1,4564,167605236,256059356,0.654556
4568,1,4568,167609804,256059356,0.654574
4569,4,18276,167628080,256059356,0.654645
4570,3,13710,167641790,256059356,0.654699
4571,1,4571,167646361,256059356,0.654717
4572,1,4572,167650933,256059356,0.654735
4574,1,4574,167655507,256059356,0.654753
4575,2,9150,167664657,256059356,0.654788
4584,2,9168,167673825,256059356,0.654824
4585,1,4585,167678410,256059356,0.654842
4589,1,4589,167682999,256059356,0.65486
4592,1,4592,167687591,256059356,0.654878
4596,1,4596,167692187,256059356,0.654896
4598,2,9196,167701383,256059356,0.654932
4606,1,4606,167705989,256059356,0.65495
4609,1,4609,167710598,256059356,0.654968
4616,1,4616,167715214,256059356,0.654986
4617,1,4617,167719831,256059356,0.655004
4619,1,4619,167724450,256059356,0.655022
4620,1,4620,167729070,256059356,0.65504
4621,1,4621,167733691,256059356,0.655058
4622,1,4622,167738313,256059356,0.655076
4625,4,18500,167756813,256059356,0.655148
4626,5,23130,167779943,256059356,0.655238
4627,1,4627,167784570,256059356,0.655257
4629,1,4629,167789199,256059356,0.655275
4631,1,4631,167793830,256059356,0.655293
4632,1,4632,167798462,256059356,0.655311
4633,1,4633,167803095,256059356,0.655329
4634,1,4634,167807729,256059356,0.655347
4639,1,4639,167812368,256059356,0.655365
4644,1,4644,167817012,256059356,0.655383
4646,1,4646,167821658,256059356,0.655401
4647,1,4647,167826305,256059356,0.65542
4648,1,4648,167830953,256059356,0.655438
4649,1,4649,167835602,256059356,0.655456
4650,1,4650,167840252,256059356,0.655474
4651,1,4651,167844903,256059356,0.655492
4652,1,4652,167849555,256059356,0.65551
4655,1,4655,167854210,256059356,0.655529
4656,1,4656,167858866,256059356,0.655547
4658,2,9316,167868182,256059356,0.655583
4660,1,4660,167872842,256059356,0.655601
4662,2,9324,167882166,256059356,0.655638
4664,1,4664,167886830,256059356,0.655656
4665,1,4665,167891495,256059356,0.655674
4670,1,4670,167896165,256059356,0.655692
4677,1,4677,167900842,256059356,0.655711
4678,1,4678,167905520,256059356,0.655729
4680,1,4680,167910200,256059356,0.655747
4682,1,4682,167914882,256059356,0.655765
4686,1,4686,167919568,256059356,0.655784
4687,1,4687,167924255,256059356,0.655802
4688,2,9376,167933631,256059356,0.655839
4689,1,4689,167938320,256059356,0.655857
4691,2,9382,167947702,256059356,0.655894
4693,2,9386,167957088,256059356,0.65593
4698,1,4698,167961786,256059356,0.655949
4699,2,9398,167971184,256059356,0.655985
4700,1,4700,167975884,256059356,0.656004
4702,1,4702,167980586,256059356,0.656022
4706,1,4706,167985292,256059356,0.65604
4707,1,4707,167989999,256059356,0.656059
4710,1,4710,167994709,256059356,0.656077
4713,1,4713,167999422,256059356,0.656096
4717,2,9434,168008856,256059356,0.656132
4719,1,4719,168013575,256059356,0.656151
4720,2,9440,168023015,256059356,0.656188
4721,1,4721,168027736,256059356,0.656206
4722,1,4722,168032458,256059356,0.656225
4723,1,4723,168037181,256059356,0.656243
4729,1,4729,168041910,256059356,0.656262
4731,1,4731,168046641,256059356,0.65628
4736,1,4736,168051377,256059356,0.656299
4737,1,4737,168056114,256059356,0.656317
4738,1,4738,168060852,256059356,0.656336
4742,1,4742,168065594,256059356,0.656354
4743,1,4743,168070337,256059356,0.656373
4744,1,4744,168075081,256059356,0.656391
4747,1,4747,168079828,256059356,0.65641
4748,1,4748,168084576,256059356,0.656428
4754,1,4754,168089330,256059356,0.656447
4755,2,9510,168098840,256059356,0.656484
4756,1,4756,168103596,256059356,0.656502
4757,1,4757,168108353,256059356,0.656521
4759,3,14277,168122630,256059356,0.656577
4762,2,9524,168132154,256059356,0.656614
4764,1,4764,168136918,256059356,0.656633
4767,1,4767,168141685,256059356,0.656651
4770,1,4770,168146455,256059356,0.65667
4773,2,9546,168156001,256059356,0.656707
4774,1,4774,168160775,256059356,0.656726
4779,1,4779,168165554,256059356,0.656744
4785,1,4785,168170339,256059356,0.656763
4791,1,4791,168175130,256059356,0.656782
4796,2,9592,168184722,256059356,0.656819
4798,1,4798,168189520,256059356,0.656838
4802,1,4802,168194322,256059356,0.656857
4805,1,4805,168199127,256059356,0.656876
4807,2,9614,168208741,256059356,0.656913
4808,1,4808,168213549,256059356,0.656932
4811,1,4811,168218360,256059356,0.656951
4816,2,9632,168227992,256059356,0.656988
4817,1,4817,168232809,256059356,0.657007
4818,1,4818,168237627,256059356,0.657026
4823,1,4823,168242450,256059356,0.657045
4825,1,4825,168247275,256059356,0.657064
4826,1,4826,168252101,256059356,0.657082
4827,1,4827,168256928,256059356,0.657101
4829,1,4829,168261757,256059356,0.65712
4830,1,4830,168266587,256059356,0.657139
4832,2,9664,168276251,256059356,0.657177
4833,1,4833,168281084,256059356,0.657196
4836,1,4836,168285920,256059356,0.657214
4838,1,4838,168290758,256059356,0.657233
4839,1,4839,168295597,256059356,0.657252
4842,1,4842,168300439,256059356,0.657271
4843,1,4843,168305282,256059356,0.65729
4845,1,4845,168310127,256059356,0.657309
4846,2,9692,168319819,256059356,0.657347
4847,2,9694,168329513,256059356,0.657385
4848,3,14544,168344057,256059356,0.657442
4849,2,9698,168353755,256059356,0.657479
4851,1,4851,168358606,256059356,0.657498
4852,3,14556,168373162,256059356,0.657555
4853,2,9706,168382868,256059356,0.657593
4854,1,4854,168387722,256059356,0.657612
4855,1,4855,168392577,256059356,0.657631
4856,1,4856,168397433,256059356,0.65765
4857,1,4857,168402290,256059356,0.657669
4860,1,4860,168407150,256059356,0.657688
4864,1,4864,168412014,256059356,0.657707
4867,2,9734,168421748,256059356,0.657745
4871,1,4871,168426619,256059356,0.657764
4872,1,4872,168431491,256059356,0.657783
4874,1,4874,168436365,256059356,0.657802
4876,1,4876,168441241,256059356,0.657821
4877,1,4877,168446118,256059356,0.65784
4880,1,4880,168450998,256059356,0.657859
4882,1,4882,168455880,256059356,0.657878
4883,1,4883,168460763,256059356,0.657897
4886,1,4886,168465649,256059356,0.657916
4888,1,4888,168470537,256059356,0.657935
4890,1,4890,168475427,256059356,0.657955
4891,1,4891,168480318,256059356,0.657974
4894,3,14682,168495000,256059356,0.658031
4895,1,4895,168499895,256059356,0.65805
4896,1,4896,168504791,256059356,0.658069
4898,1,4898,168509689,256059356,0.658088
4901,1,4901,168514590,256059356,0.658108
4903,1,4903,168519493,256059356,0.658127
4910,2,9820,168529313,256059356,0.658165
4912,1,4912,168534225,256059356,0.658184
4913,1,4913,168539138,256059356,0.658203
4919,1,4919,168544057,256059356,0.658223
4921,1,4921,168548978,256059356,0.658242
4924,1,4924,168553902,256059356,0.658261
4926,1,4926,168558828,256059356,0.65828
4928,1,4928,168563756,256059356,0.6583
4929,2,9858,168573614,256059356,0.658338
4931,2,9862,168583476,256059356,0.658377
4936,1,4936,168588412,256059356,0.658396
4937,1,4937,168593349,256059356,0.658415
4938,3,14814,168608163,256059356,0.658473
4939,1,4939,168613102,256059356,0.658492
4940,1,4940,168618042,256059356,0.658512
4942,2,9884,168627926,256059356,0.65855
4945,1,4945,168632871,256059356,0.658569
4946,1,4946,168637817,256059356,0.658589
4951,1,4951,168642768,256059356,0.658608
4952,2,9904,168652672,256059356,0.658647
4953,2,9906,168662578,256059356,0.658685
4958,1,4958,168667536,256059356,0.658705
4960,1,4960,168672496,256059356,0.658724
4963,1,4963,168677459,256059356,0.658744
4966,1,4966,168682425,256059356,0.658763
4968,1,4968,168687393,256059356,0.658782
4969,1,4969,168692362,256059356,0.658802
4971,1,4971,168697333,256059356,0.658821
4972,1,4972,168702305,256059356,0.658841
4974,1,4974,168707279,256059356,0.65886
4976,2,9952,168717231,256059356,0.658899
4977,1,4977,168722208,256059356,0.658918
4979,1,4979,168727187,256059356,0.658938
4980,1,4980,168732167,256059356,0.658957
4982,4,19928,168752095,256059356,0.659035
4983,6,29898,168781993,256059356,0.659152
4984,2,9968,168791961,256059356,0.659191
4986,3,14958,168806919,256059356,0.659249
4987,2,9974,168816893,256059356,0.659288
4988,1,4988,168821881,256059356,0.659308
4989,1,4989,168826870,256059356,0.659327
4990,2,9980,168836850,256059356,0.659366
4991,2,9982,168846832,256059356,0.659405
4992,3,14976,168861808,256059356,0.659464
4993,2,9986,168871794,256059356,0.659503
4994,1,4994,168876788,256059356,0.659522
4995,3,14985,168891773,256059356,0.659581
4996,2,9992,168901765,256059356,0.65962
4998,1,4998,168906763,256059356,0.659639
4999,1,4999,168911762,256059356,0.659659
5002,1,5002,168916764,256059356,0.659678
5005,1,5005,168921769,256059356,0.659698
5009,2,10018,168931787,256059356,0.659737
5010,2,10020,168941807,256059356,0.659776
5011,1,5011,168946818,256059356,0.659796
5013,1,5013,168951831,256059356,0.659815
5016,2,10032,168961863,256059356,0.659854
5017,1,5017,168966880,256059356,0.659874
5018,1,5018,168971898,256059356,0.659893
5019,1,5019,168976917,256059356,0.659913
5020,1,5020,168981937,256059356,0.659933
5021,1,5021,168986958,256059356,0.659952
5022,1,5022,168991980,256059356,0.659972
5023,1,5023,168997003,256059356,0.659992
5025,1,5025,169002028,256059356,0.660011
5026,1,5026,169007054,256059356,0.660031
5028,1,5028,169012082,256059356,0.66005
5029,1,5029,169017111,256059356,0.66007
5032,1,5032,169022143,256059356,0.66009
5033,1,5033,169027176,256059356,0.660109
5034,2,10068,169037244,256059356,0.660149
5035,1,5035,169042279,256059356,0.660168
5037,2,10074,169052353,256059356,0.660208
5042,1,5042,169057395,256059356,0.660227
5044,1,5044,169062439,256059356,0.660247
5048,2,10096,169072535,256059356,0.660286
5049,2,10098,169082633,256059356,0.660326
5050,1,5050,169087683,256059356,0.660346
5052,5,25260,169112943,256059356,0.660444
5053,2,10106,169123049,256059356,0.660484
5055,1,5055,169128104,256059356,0.660504
5056,2,10112,169138216,256059356,0.660543
5057,4,20228,169158444,256059356,0.660622
5060,1,5060,169163504,256059356,0.660642
5061,3,15183,169178687,256059356,0.660701
5062,1,5062,169183749,256059356,0.660721
5063,1,5063,169188812,256059356,0.660741
5064,3,15192,169204004,256059356,0.6608
5070,1,5070,169209074,256059356,0.66082
5073,1,5073,169214147,256059356,0.66084
5074,2,10148,169224295,256059356,0.660879
5081,1,5081,169229376,256059356,0.660899
5086,1,5086,169234462,256059356,0.660919
5087,3,15261,169249723,256059356,0.660978
5089,1,5089,169254812,256059356,0.660998
5090,1,5090,169259902,256059356,0.661018
5092,2,10184,169270086,256059356,0.661058
5094,1,5094,169275180,256059356,0.661078
5097,2,10194,169285374,256059356,0.661118
5099,2,10198,169295572,256059356,0.661158
5101,1,5101,169300673,256059356,0.661177
5103,1,5103,169305776,256059356,0.661197
5104,1,5104,169310880,256059356,0.661217
5109,1,5109,169315989,256059356,0.661237
5110,1,5110,169321099,256059356,0.661257
5114,1,5114,169326213,256059356,0.661277
5116,1,5116,169331329,256059356,0.661297
5121,1,5121,169336450,256059356,0.661317
5122,2,10244,169346694,256059356,0.661357
5125,1,5125,169351819,256059356,0.661377
5126,1,5126,169356945,256059356,0.661397
5128,2,10256,169367201,256059356,0.661437
5133,1,5133,169372334,256059356,0.661457
5135,1,5135,169377469,256059356,0.661477
5137,1,5137,169382606,256059356,0.661497
5138,2,10276,169392882,256059356,0.661538
5140,1,5140,169398022,256059356,0.661558
5141,2,10282,169408304,256059356,0.661598
5144,1,5144,169413448,256059356,0.661618
5145,2,10290,169423738,256059356,0.661658
5146,1,5146,169428884,256059356,0.661678
5148,2,10296,169439180,256059356,0.661718
5149,1,5149,169444329,256059356,0.661738
5151,2,10302,169454631,256059356,0.661779
5152,1,5152,169459783,256059356,0.661799
5155,1,5155,169464938,256059356,0.661819
5156,1,5156,169470094,256059356,0.661839
5159,1,5159,169475253,256059356,0.661859
5160,1,5160,169480413,256059356,0.661879
5162,1,5162,169485575,256059356,0.6619
5166,1,5166,169490741,256059356,0.66192
5168,1,5168,169495909,256059356,0.66194
5169,1,5169,169501078,256059356,0.66196
5175,1,5175,169506253,256059356,0.66198
5179,2,10358,169516611,256059356,0.662021
5181,1,5181,169521792,256059356,0.662041
5185,1,5185,169526977,256059356,0.662061
5188,1,5188,169532165,256059356,0.662082
5189,1,5189,169537354,256059356,0.662102
5195,1,5195,169542549,256059356,0.662122
5198,1,5198,169547747,256059356,0.662142
5201,1,5201,169552948,256059356,0.662163
5204,1,5204,169558152,256059356,0.662183
5206,1,5206,169563358,256059356,0.662203
5207,1,5207,169568565,256059356,0.662224
5216,2,10432,169578997,256059356,0.662264
5225,1,5225,169584222,256059356,0.662285
5226,2,10452,169594674,256059356,0.662326
5228,1,5228,169599902,256059356,0.662346
5230,1,5230,169605132,256059356,0.662366
5232,1,5232,169610364,256059356,0.662387
5233,2,10466,169620830,256059356,0.662428
5237,1,5237,169626067,256059356,0.662448
5240,1,5240,169631307,256059356,0.662469
5241,1,5241,169636548,256059356,0.662489
5242,1,5242,169641790,256059356,0.66251
5246,1,5246,169647036,256059356,0.66253
5251,1,5251,169652287,256059356,0.662551
5253,1,5253,169657540,256059356,0.662571
5260,1,5260,169662800,256059356,0.662592
5262,1,5262,169668062,256059356,0.662612
5263,1,5263,169673325,256059356,0.662633
5266,1,5266,169678591,256059356,0.662653
5267,1,5267,169683858,256059356,0.662674
5270,1,5270,169689128,256059356,0.662695
5275,2,10550,169699678,256059356,0.662736
5279,1,5279,169704957,256059356,0.662756
5281,1,5281,169710238,256059356,0.662777
5282,1,5282,169715520,256059356,0.662798
5284,2,10568,169726088,256059356,0.662839
5285,1,5285,169731373,256059356,0.662859
5286,3,15858,169747231,256059356,0.662921
5288,1,5288,169752519,256059356,0.662942
5295,1,5295,169757814,256059356,0.662963
5298,1,5298,169763112,256059356,0.662983
5303,1,5303,169768415,256059356,0.663004
5304,2,10608,169779023,256059356,0.663046
5305,2,10610,169789633,256059356,0.663087
5306,1,5306,169794939,256059356,0.663108
5307,1,5307,169800246,256059356,0.663128
5310,1,5310,169805556,256059356,0.663149
5311,1,5311,169810867,256059356,0.66317
5313,2,10626,169821493,256059356,0.663211
5315,1,5315,169826808,256059356,0.663232
5320,1,5320,169832128,256059356,0.663253
5327,1,5327,169837455,256059356,0.663274
5328,2,10656,169848111,256059356,0.663315
5333,1,5333,169853444,256059356,0.663336
5336,1,5336,169858780,256059356,0.663357
5339,2,10678,169869458,256059356,0.663399
5341,1,5341,169874799,256059356,0.66342
5343,1,5343,169880142,256059356,0.66344
5346,2,10692,169890834,256059356,0.663482
5350,1,5350,169896184,256059356,0.663503
5352,1,5352,169901536,256059356,0.663524
5357,1,5357,169906893,256059356,0.663545
5359,1,5359,169912252,256059356,0.663566
5361,1,5361,169917613,256059356,0.663587
5368,1,5368,169922981,256059356,0.663608
5371,1,5371,169928352,256059356,0.663629
5374,1,5374,169933726,256059356,0.66365
5378,2,10756,169944482,256059356,0.663692
5379,1,5379,169949861,256059356,0.663713
5380,1,5380,169955241,256059356,0.663734
5384,1,5384,169960625,256059356,0.663755
5389,1,5389,169966014,256059356,0.663776
5392,1,5392,169971406,256059356,0.663797
5393,1,5393,169976799,256059356,0.663818
5397,1,5397,169982196,256059356,0.663839
5398,1,5398,169987594,256059356,0.66386
5405,1,5405,169992999,256059356,0.663881
5406,1,5406,169998405,256059356,0.663902
5408,1,5408,170003813,256059356,0.663923
5414,1,5414,170009227,256059356,0.663945
5417,1,5417,170014644,256059356,0.663966
5418,1,5418,170020062,256059356,0.663987
5420,2,10840,170030902,256059356,0.664029
5421,1,5421,170036323,256059356,0.66405
5423,1,5423,170041746,256059356,0.664072
5425,1,5425,170047171,256059356,0.664093
5426,1,5426,170052597,256059356,0.664114
5427,3,16281,170068878,256059356,0.664178
5430,1,5430,170074308,256059356,0.664199
5433,1,5433,170079741,256059356,0.66422
5441,1,5441,170085182,256059356,0.664241
5444,1,5444,170090626,256059356,0.664262
5445,1,5445,170096071,256059356,0.664284
5446,1,5446,170101517,256059356,0.664305
5450,1,5450,170106967,256059356,0.664326
5451,1,5451,170112418,256059356,0.664348
5454,1,5454,170117872,256059356,0.664369
5457,1,5457,170123329,256059356,0.66439
5458,1,5458,170128787,256059356,0.664412
5462,1,5462,170134249,256059356,0.664433
5463,1,5463,170139712,256059356,0.664454
5470,1,5470,170145182,256059356,0.664476
5471,1,5471,170150653,256059356,0.664497
5473,1,5473,170156126,256059356,0.664518
5476,1,5476,170161602,256059356,0.66454
5478,1,5478,170167080,256059356,0.664561
5482,2,10964,170178044,256059356,0.664604
5483,2,10966,170189010,256059356,0.664647
5490,1,5490,170194500,256059356,0.664668
5493,1,5493,170199993,256059356,0.66469
5495,1,5495,170205488,256059356,0.664711
5498,1,5498,170210986,256059356,0.664733
5501,1,5501,170216487,256059356,0.664754
5503,1,5503,170221990,256059356,0.664776
5504,2,11008,170232998,256059356,0.664819
5505,1,5505,170238503,256059356,0.66484
5508,1,5508,170244011,256059356,0.664862
5509,2,11018,170255029,256059356,0.664905
5511,1,5511,170260540,256059356,0.664926
5514,1,5514,170266054,256059356,0.664948
5517,1,5517,170271571,256059356,0.664969
5518,2,11036,170282607,256059356,0.665012
5519,1,5519,170288126,256059356,0.665034
5525,1,5525,170293651,256059356,0.665055
5532,1,5532,170299183,256059356,0.665077
5540,1,5540,170304723,256059356,0.665099
5541,2,11082,170315805,256059356,0.665142
5543,1,5543,170321348,256059356,0.665164
5547,1,5547,170326895,256059356,0.665185
5548,1,5548,170332443,256059356,0.665207
5551,1,5551,170337994,256059356,0.665229
5553,1,5553,170343547,256059356,0.66525
5561,1,5561,170349108,256059356,0.665272
5568,1,5568,170354676,256059356,0.665294
5569,1,5569,170360245,256059356,0.665315
5571,1,5571,170365816,256059356,0.665337
5574,1,5574,170371390,256059356,0.665359
5575,1,5575,170376965,256059356,0.665381
5576,1,5576,170382541,256059356,0.665403
5577,2,11154,170393695,256059356,0.665446
5581,1,5581,170399276,256059356,0.665468
5583,1,5583,170404859,256059356,0.66549
5596,2,11192,170416051,256059356,0.665533
5597,1,5597,170421648,256059356,0.665555
5602,1,5602,170427250,256059356,0.665577
5606,1,5606,170432856,256059356,0.665599
5607,1,5607,170438463,256059356,0.665621
5612,1,5612,170444075,256059356,0.665643
5613,1,5613,170449688,256059356,0.665665
5615,2,11230,170460918,256059356,0.665709
5616,1,5616,170466534,256059356,0.665731
5618,1,5618,170472152,256059356,0.665752
5619,1,5619,170477771,256059356,0.665774
5625,1,5625,170483396,256059356,0.665796
5629,1,5629,170489025,256059356,0.665818
5639,1,5639,170494664,256059356,0.66584
5640,1,5640,170500304,256059356,0.665862
5642,1,5642,170505946,256059356,0.665884
5644,1,5644,170511590,256059356,0.665907
5650,1,5650,170517240,256059356,0.665929
5655,1,5655,170522895,256059356,0.665951
5660,1,5660,170528555,256059356,0.665973
5661,1,5661,170534216,256059356,0.665995
5666,2,11332,170545548,256059356,0.666039
5667,1,5667,170551215,256059356,0.666061
5669,1,5669,170556884,256059356,0.666083
5672,1,5672,170562556,256059356,0.666106
5676,1,5676,170568232,256059356,0.666128
5682,1,5682,170573914,256059356,0.66615
5684,1,5684,170579598,256059356,0.666172
5688,1,5688,170585286,256059356,0.666194
5693,1,5693,170590979,256059356,0.666217
5696,1,5696,170596675,256059356,0.666239
5700,1,5700,170602375,256059356,0.666261
5702,1,5702,170608077,256059356,0.666283
5707,1,5707,170613784,256059356,0.666306
5713,1,5713,170619497,256059356,0.666328
5717,1,5717,170625214,256059356,0.66635
5728,1,5728,170630942,256059356,0.666373
5733,2,11466,170642408,256059356,0.666417
5734,1,5734,170648142,256059356,0.66644
5736,1,5736,170653878,256059356,0.666462
5737,1,5737,170659615,256059356,0.666485
5745,1,5745,170665360,256059356,0.666507
5753,1,5753,170671113,256059356,0.666529
5756,1,5756,170676869,256059356,0.666552
5758,1,5758,170682627,256059356,0.666574
5763,1,5763,170688390,256059356,0.666597
5765,2,11530,170699920,256059356,0.666642
5776,1,5776,170705696,256059356,0.666665
5778,1,5778,170711474,256059356,0.666687
5788,1,5788,170717262,256059356,0.66671
5793,1,5793,170723055,256059356,0.666732
5794,1,5794,170728849,256059356,0.666755
5796,1,5796,170734645,256059356,0.666778
5797,1,5797,170740442,256059356,0.6668
5800,1,5800,170746242,256059356,0.666823
5801,1,5801,170752043,256059356,0.666846
5802,1,5802,170757845,256059356,0.666868
5803,1,5803,170763648,256059356,0.666891
5815,1,5815,170769463,256059356,0.666914
5822,2,11644,170781107,256059356,0.666959
5827,2,11654,170792761,256059356,0.667005
5835,1,5835,170798596,256059356,0.667027
5837,1,5837,170804433,256059356,0.66705
5840,1,5840,170810273,256059356,0.667073
5844,1,5844,170816117,256059356,0.667096
5847,1,5847,170821964,256059356,0.667119
5848,1,5848,170827812,256059356,0.667141
5854,1,5854,170833666,256059356,0.667164
5857,1,5857,170839523,256059356,0.667187
5867,1,5867,170845390,256059356,0.66721
5868,1,5868,170851258,256059356,0.667233
5870,2,11740,170862998,256059356,0.667279
5881,2,11762,170874760,256059356,0.667325
5887,1,5887,170880647,256059356,0.667348
5896,1,5896,170886543,256059356,0.667371
5897,1,5897,170892440,256059356,0.667394
5901,1,5901,170898341,256059356,0.667417
5902,2,11804,170910145,256059356,0.667463
5904,1,5904,170916049,256059356,0.667486
5910,1,5910,170921959,256059356,0.667509
5912,1,5912,170927871,256059356,0.667532
5913,1,5913,170933784,256059356,0.667555
5924,1,5924,170939708,256059356,0.667578
5934,1,5934,170945642,256059356,0.667602
5935,1,5935,170951577,256059356,0.667625
5940,1,5940,170957517,256059356,0.667648
5945,1,5945,170963462,256059356,0.667671
5949,1,5949,170969411,256059356,0.667694
5951,1,5951,170975362,256059356,0.667718
5955,1,5955,170981317,256059356,0.667741
5961,1,5961,170987278,256059356,0.667764
5968,1,5968,170993246,256059356,0.667788
5972,3,17916,171011162,256059356,0.667858
5974,1,5974,171017136,256059356,0.667881
5984,1,5984,171023120,256059356,0.667904
5987,1,5987,171029107,256059356,0.667928
5988,1,5988,171035095,256059356,0.667951
5989,1,5989,171041084,256059356,0.667974
5992,1,5992,171047076,256059356,0.667998
5993,1,5993,171053069,256059356,0.668021
5994,1,5994,171059063,256059356,0.668045
5995,1,5995,171065058,256059356,0.668068
5998,1,5998,171071056,256059356,0.668091
6003,1,6003,171077059,256059356,0.668115
6004,1,6004,171083063,256059356,0.668138
6007,1,6007,171089070,256059356,0.668162
6011,1,6011,171095081,256059356,0.668185
6020,1,6020,171101101,256059356,0.668209
6023,1,6023,171107124,256059356,0.668232
6026,1,6026,171113150,256059356,0.668256
6027,1,6027,171119177,256059356,0.668279
6028,2,12056,171131233,256059356,0.668326
6033,1,6033,171137266,256059356,0.66835
6034,1,6034,171143300,256059356,0.668374
6037,1,6037,171149337,256059356,0.668397
6049,1,6049,171155386,256059356,0.668421
6050,1,6050,171161436,256059356,0.668444
6055,1,6055,171167491,256059356,0.668468
6057,1,6057,171173548,256059356,0.668492
6069,1,6069,171179617,256059356,0.668515
6070,1,6070,171185687,256059356,0.668539
6074,1,6074,171191761,256059356,0.668563
6082,1,6082,171197843,256059356,0.668587
6085,1,6085,171203928,256059356,0.66861
6092,1,6092,171210020,256059356,0.668634
6093,1,6093,171216113,256059356,0.668658
6094,1,6094,171222207,256059356,0.668682
6098,2,12196,171234403,256059356,0.668729
6104,1,6104,171240507,256059356,0.668753
6107,1,6107,171246614,256059356,0.668777
6110,1,6110,171252724,256059356,0.668801
6111,1,6111,171258835,256059356,0.668825
6114,1,6114,171264949,256059356,0.668849
6122,1,6122,171271071,256059356,0.668873
6134,1,6134,171277205,256059356,0.668896
6141,1,6141,171283346,256059356,0.66892
6150,1,6150,171289496,256059356,0.668944
6151,1,6151,171295647,256059356,0.668969
6156,1,6156,171301803,256059356,0.668993
6157,1,6157,171307960,256059356,0.669017
6159,1,6159,171314119,256059356,0.669041
6167,1,6167,171320286,256059356,0.669065
6170,1,6170,171326456,256059356,0.669089
6172,2,12344,171338800,256059356,0.669137
6173,1,6173,171344973,256059356,0.669161
6180,1,6180,171351153,256059356,0.669185
6187,1,6187,171357340,256059356,0.669209
6189,1,6189,171363529,256059356,0.669234
6194,1,6194,171369723,256059356,0.669258
6197,1,6197,171375920,256059356,0.669282
6198,1,6198,171382118,256059356,0.669306
6199,1,6199,171388317,256059356,0.66933
6202,2,12404,171400721,256059356,0.669379
6206,1,6206,171406927,256059356,0.669403
6207,2,12414,171419341,256059356,0.669452
6209,1,6209,171425550,256059356,0.669476
6210,1,6210,171431760,256059356,0.6695
6212,1,6212,171437972,256059356,0.669524
6213,3,18639,171456611,256059356,0.669597
6215,1,6215,171462826,256059356,0.669621
6216,2,12432,171475258,256059356,0.66967
6217,1,6217,171481475,256059356,0.669694
6221,1,6221,171487696,256059356,0.669719
6222,1,6222,171493918,256059356,0.669743
6224,1,6224,171500142,256059356,0.669767
6226,2,12452,171512594,256059356,0.669816
6227,1,6227,171518821,256059356,0.66984
6228,1,6228,171525049,256059356,0.669864
6229,1,6229,171531278,256059356,0.669889
6234,1,6234,171537512,256059356,0.669913
6238,1,6238,171543750,256059356,0.669937
6244,3,18732,171562482,256059356,0.670011
6246,1,6246,171568728,256059356,0.670035
6249,1,6249,171574977,256059356,0.670059
6250,2,12500,171587477,256059356,0.670108
6251,1,6251,171593728,256059356,0.670133
6253,1,6253,171599981,256059356,0.670157
6254,1,6254,171606235,256059356,0.670181
6255,1,6255,171612490,256059356,0.670206
6262,1,6262,171618752,256059356,0.67023
6263,2,12526,171631278,256059356,0.670279
6264,1,6264,171637542,256059356,0.670304
6265,1,6265,171643807,256059356,0.670328
6267,1,6267,171650074,256059356,0.670353
6273,1,6273,171656347,256059356,0.670377
6288,1,6288,171662635,256059356,0.670402
6290,1,6290,171668925,256059356,0.670426
6293,1,6293,171675218,256059356,0.670451
6298,1,6298,171681516,256059356,0.670475
6301,1,6301,171687817,256059356,0.6705
6308,2,12616,171700433,256059356,0.670549
6310,1,6310,171706743,256059356,0.670574
6312,1,6312,171713055,256059356,0.670599
6321,1,6321,171719376,256059356,0.670623
6330,1,6330,171725706,256059356,0.670648
6332,1,6332,171732038,256059356,0.670673
6334,1,6334,171738372,256059356,0.670698
6337,1,6337,171744709,256059356,0.670722
6343,1,6343,171751052,256059356,0.670747
6346,1,6346,171757398,256059356,0.670772
6349,1,6349,171763747,256059356,0.670797
6350,1,6350,171770097,256059356,0.670821
6354,1,6354,171776451,256059356,0.670846
6356,2,12712,171789163,256059356,0.670896
6363,1,6363,171795526,256059356,0.670921
6372,1,6372,171801898,256059356,0.670946
6376,1,6376,171808274,256059356,0.67097
6389,1,6389,171814663,256059356,0.670995
6396,1,6396,171821059,256059356,0.67102
6398,1,6398,171827457,256059356,0.671045
6399,1,6399,171833856,256059356,0.67107
6406,1,6406,171840262,256059356,0.671095
6408,1,6408,171846670,256059356,0.67112
6410,1,6410,171853080,256059356,0.671145
6415,1,6415,171859495,256059356,0.671171
6420,1,6420,171865915,256059356,0.671196
6437,1,6437,171872352,256059356,0.671221
6440,1,6440,171878792,256059356,0.671246
6442,1,6442,171885234,256059356,0.671271
6443,1,6443,171891677,256059356,0.671296
6444,1,6444,171898121,256059356,0.671321
6446,1,6446,171904567,256059356,0.671347
6449,1,6449,171911016,256059356,0.671372
6467,1,6467,171917483,256059356,0.671397
6478,1,6478,171923961,256059356,0.671422
6479,1,6479,171930440,256059356,0.671448
6481,1,6481,171936921,256059356,0.671473
6482,1,6482,171943403,256059356,0.671498
6489,1,6489,171949892,256059356,0.671524
6494,2,12988,171962880,256059356,0.671574
6497,1,6497,171969377,256059356,0.6716
6502,1,6502,171975879,256059356,0.671625
6503,2,13006,171988885,256059356,0.671676
6504,1,6504,171995389,256059356,0.671701
6506,1,6506,172001895,256059356,0.671727
6507,1,6507,172008402,256059356,0.671752
6508,1,6508,172014910,256059356,0.671777
6511,1,6511,172021421,256059356,0.671803
6513,1,6513,172027934,256059356,0.671828
6516,1,6516,172034450,256059356,0.671854
6520,1,6520,172040970,256059356,0.671879
6524,1,6524,172047494,256059356,0.671905
6526,1,6526,172054020,256059356,0.67193
6528,1,6528,172060548,256059356,0.671956
6529,1,6529,172067077,256059356,0.671981
6533,1,6533,172073610,256059356,0.672007
6537,2,13074,172086684,256059356,0.672058
6547,1,6547,172093231,256059356,0.672083
6550,1,6550,172099781,256059356,0.672109
6556,2,13112,172112893,256059356,0.67216
6565,1,6565,172119458,256059356,0.672186
6579,1,6579,172126037,256059356,0.672211
6587,1,6587,172132624,256059356,0.672237
6593,1,6593,172139217,256059356,0.672263
6600,1,6600,172145817,256059356,0.672289
6606,1,6606,172152423,256059356,0.672315
6607,1,6607,172159030,256059356,0.67234
6608,1,6608,172165638,256059356,0.672366
6609,2,13218,172178856,256059356,0.672418
6611,1,6611,172185467,256059356,0.672444
6613,2,13226,172198693,256059356,0.672495
6614,1,6614,172205307,256059356,0.672521
6616,1,6616,172211923,256059356,0.672547
6622,2,13244,172225167,256059356,0.672599
6628,1,6628,172231795,256059356,0.672624
6630,1,6630,172238425,256059356,0.67265
6637,1,6637,172245062,256059356,0.672676
6638,1,6638,172251700,256059356,0.672702
6642,1,6642,172258342,256059356,0.672728
6645,1,6645,172264987,256059356,0.672754
6648,2,13296,172278283,256059356,0.672806
6650,1,6650,172284933,256059356,0.672832
6653,1,6653,172291586,256059356,0.672858
6663,1,6663,172298249,256059356,0.672884
6668,1,6668,172304917,256059356,0.67291
6675,1,6675,172311592,256059356,0.672936
6676,1,6676,172318268,256059356,0.672962
6678,2,13356,172331624,256059356,0.673014
6682,2,13364,172344988,256059356,0.673067
6683,1,6683,172351671,256059356,0.673093
6689,1,6689,172358360,256059356,0.673119
6691,1,6691,172365051,256059356,0.673145
6692,1,6692,172371743,256059356,0.673171
6693,2,13386,172385129,256059356,0.673223
6695,1,6695,172391824,256059356,0.673249
6697,1,6697,172398521,256059356,0.673276
6700,1,6700,172405221,256059356,0.673302
6702,1,6702,172411923,256059356,0.673328
6706,1,6706,172418629,256059356,0.673354
6709,1,6709,172425338,256059356,0.67338
6722,1,6722,172432060,256059356,0.673407
6725,1,6725,172438785,256059356,0.673433
6728,1,6728,172445513,256059356,0.673459
6729,1,6729,172452242,256059356,0.673485
6731,1,6731,172458973,256059356,0.673512
6732,1,6732,172465705,256059356,0.673538
6733,1,6733,172472438,256059356,0.673564
6738,2,13476,172485914,256059356,0.673617
6739,1,6739,172492653,256059356,0.673643
6743,1,6743,172499396,256059356,0.67367
6745,1,6745,172506141,256059356,0.673696
6748,1,6748,172512889,256059356,0.673722
6749,1,6749,172519638,256059356,0.673749
6751,3,20253,172539891,256059356,0.673828
6754,2,13508,172553399,256059356,0.67388
6755,1,6755,172560154,256059356,0.673907
6756,1,6756,172566910,256059356,0.673933
6760,1,6760,172573670,256059356,0.67396
6766,2,13532,172587202,256059356,0.674012
6770,1,6770,172593972,256059356,0.674039
6773,1,6773,172600745,256059356,0.674065
6777,1,6777,172607522,256059356,0.674092
6781,1,6781,172614303,256059356,0.674118
6787,1,6787,172621090,256059356,0.674145
6792,1,6792,172627882,256059356,0.674171
6793,1,6793,172634675,256059356,0.674198
6794,1,6794,172641469,256059356,0.674224
6800,1,6800,172648269,256059356,0.674251
6811,1,6811,172655080,256059356,0.674278
6817,1,6817,172661897,256059356,0.674304
6820,1,6820,172668717,256059356,0.674331
6826,1,6826,172675543,256059356,0.674357
6827,1,6827,172682370,256059356,0.674384
6829,1,6829,172689199,256059356,0.674411
6833,1,6833,172696032,256059356,0.674438
6836,2,13672,172709704,256059356,0.674491
6840,1,6840,172716544,256059356,0.674518
6846,1,6846,172723390,256059356,0.674544
6861,2,13722,172737112,256059356,0.674598
6865,1,6865,172743977,256059356,0.674625
6866,1,6866,172750843,256059356,0.674652
6869,2,13738,172764581,256059356,0.674705
6870,1,6870,172771451,256059356,0.674732
6872,2,13744,172785195,256059356,0.674786
6874,1,6874,172792069,256059356,0.674813
6875,1,6875,172798944,256059356,0.674839
6877,1,6877,172805821,256059356,0.674866
6882,1,6882,172812703,256059356,0.674893
6884,1,6884,172819587,256059356,0.67492
6892,1,6892,172826479,256059356,0.674947
6893,1,6893,172833372,256059356,0.674974
6901,1,6901,172840273,256059356,0.675001
6902,1,6902,172847175,256059356,0.675028
6908,1,6908,172854083,256059356,0.675055
6913,1,6913,172860996,256059356,0.675082
6920,1,6920,172867916,256059356,0.675109
6922,1,6922,172874838,256059356,0.675136
6930,1,6930,172881768,256059356,0.675163
6931,1,6931,172888699,256059356,0.67519
6932,2,13864,172902563,256059356,0.675244
6944,1,6944,172909507,256059356,0.675271
6945,1,6945,172916452,256059356,0.675298
6948,1,6948,172923400,256059356,0.675325
6949,2,13898,172937298,256059356,0.67538
6952,1,6952,172944250,256059356,0.675407
6958,2,13916,172958166,256059356,0.675461
6964,1,6964,172965130,256059356,0.675488
6968,1,6968,172972098,256059356,0.675516
6971,1,6971,172979069,256059356,0.675543
6972,1,6972,172986041,256059356,0.67557
6975,1,6975,172993016,256059356,0.675597
6979,2,13958,173006974,256059356,0.675652
6997,1,6997,173013971,256059356,0.675679
6999,1,6999,173020970,256059356,0.675706
7000,1,7000,173027970,256059356,0.675734
7004,1,7004,173034974,256059356,0.675761
7007,1,7007,173041981,256059356,0.675789
7008,1,7008,173048989,256059356,0.675816
7015,2,14030,173063019,256059356,0.675871
7016,1,7016,173070035,256059356,0.675898
7021,2,14042,173084077,256059356,0.675953
7022,1,7022,173091099,256059356,0.67598
7023,1,7023,173098122,256059356,0.676008
7025,1,7025,173105147,256059356,0.676035
7039,1,7039,173112186,256059356,0.676063
7040,1,7040,173119226,256059356,0.67609
7046,2,14092,173133318,256059356,0.676145
7047,3,21141,173154459,256059356,0.676228
7049,2,14098,173168557,256059356,0.676283
7051,1,7051,173175608,256059356,0.67631
7052,1,7052,173182660,256059356,0.676338
7054,1,7054,173189714,256059356,0.676365
7055,1,7055,173196769,256059356,0.676393
7057,3,21171,173217940,256059356,0.676476
7058,2,14116,173232056,256059356,0.676531
7061,1,7061,173239117,256059356,0.676558
7063,1,7063,173246180,256059356,0.676586
7078,1,7078,173253258,256059356,0.676614
7080,1,7080,173260338,256059356,0.676641
7082,1,7082,173267420,256059356,0.676669
7088,1,7088,173274508,256059356,0.676697
7091,1,7091,173281599,256059356,0.676724
7092,1,7092,173288691,256059356,0.676752
7095,1,7095,173295786,256059356,0.67678
7099,1,7099,173302885,256059356,0.676807
7100,1,7100,173309985,256059356,0.676835
7101,1,7101,173317086,256059356,0.676863
7104,1,7104,173324190,256059356,0.676891
7106,1,7106,173331296,256059356,0.676918
7107,1,7107,173338403,256059356,0.676946
7108,1,7108,173345511,256059356,0.676974
7111,1,7111,173352622,256059356,0.677002
7113,1,7113,173359735,256059356,0.677029
7114,1,7114,173366849,256059356,0.677057
7118,1,7118,173373967,256059356,0.677085
7121,1,7121,173381088,256059356,0.677113
7124,2,14248,173395336,256059356,0.677169
7125,1,7125,173402461,256059356,0.677196
7126,2,14252,173416713,256059356,0.677252
7130,1,7130,173423843,256059356,0.67728
7131,1,7131,173430974,256059356,0.677308
7143,2,14286,173445260,256059356,0.677363
7144,1,7144,173452404,256059356,0.677391
7145,2,14290,173466694,256059356,0.677447
7152,1,7152,173473846,256059356,0.677475
7156,1,7156,173481002,256059356,0.677503
7165,1,7165,173488167,256059356,0.677531
7167,2,14334,173502501,256059356,0.677587
7169,1,7169,173509670,256059356,0.677615
7170,1,7170,173516840,256059356,0.677643
7173,1,7173,173524013,256059356,0.677671
7174,1,7174,173531187,256059356,0.677699
7176,1,7176,173538363,256059356,0.677727
7186,1,7186,173545549,256059356,0.677755
7198,1,7198,173552747,256059356,0.677783
7200,1,7200,173559947,256059356,0.677811
7203,1,7203,173567150,256059356,0.67784
7208,1,7208,173574358,256059356,0.677868
7213,1,7213,173581571,256059356,0.677896
7216,1,7216,173588787,256059356,0.677924
7219,1,7219,173596006,256059356,0.677952
7220,2,14440,173610446,256059356,0.678009
7221,1,7221,173617667,256059356,0.678037
7223,1,7223,173624890,256059356,0.678065
7225,1,7225,173632115,256059356,0.678093
7229,1,7229,173639344,256059356,0.678121
7235,1,7235,173646579,256059356,0.67815
7240,1,7240,173653819,256059356,0.678178
7246,1,7246,173661065,256059356,0.678206
7252,1,7252,173668317,256059356,0.678235
7254,1,7254,173675571,256059356,0.678263
7257,1,7257,173682828,256059356,0.678291
7261,1,7261,173690089,256059356,0.67832
7265,1,7265,173697354,256059356,0.678348
7270,3,21810,173719164,256059356,0.678433
7277,1,7277,173726441,256059356,0.678462
7279,1,7279,173733720,256059356,0.67849
7287,1,7287,173741007,256059356,0.678518
7293,2,14586,173755593,256059356,0.678575
7301,2,14602,173770195,256059356,0.678632
7309,1,7309,173777504,256059356,0.678661
7310,1,7310,173784814,256059356,0.67869
7312,1,7312,173792126,256059356,0.678718
7313,1,7313,173799439,256059356,0.678747
7319,2,14638,173814077,256059356,0.678804
7320,1,7320,173821397,256059356,0.678832
7322,1,7322,173828719,256059356,0.678861
7326,1,7326,173836045,256059356,0.67889
7331,1,7331,173843376,256059356,0.678918
7332,1,7332,173850708,256059356,0.678947
7334,1,7334,173858042,256059356,0.678976
7335,1,7335,173865377,256059356,0.679004
7337,1,7337,173872714,256059356,0.679033
7339,1,7339,173880053,256059356,0.679062
7341,1,7341,173887394,256059356,0.67909
7345,1,7345,173894739,256059356,0.679119
7351,1,7351,173902090,256059356,0.679148
7367,1,7367,173909457,256059356,0.679176
7371,1,7371,173916828,256059356,0.679205
7376,1,7376,173924204,256059356,0.679234
7377,1,7377,173931581,256059356,0.679263
7382,1,7382,173938963,256059356,0.679292
7386,1,7386,173946349,256059356,0.67932
7387,1,7387,173953736,256059356,0.679349
7388,2,14776,173968512,256059356,0.679407
7392,2,14784,173983296,256059356,0.679465
7397,3,22191,174005487,256059356,0.679551
7399,1,7399,174012886,256059356,0.67958
7406,1,7406,174020292,256059356,0.679609
7408,2,14816,174035108,256059356,0.679667
7409,2,14818,174049926,256059356,0.679725
7412,1,7412,174057338,256059356,0.679754
7428,1,7428,174064766,256059356,0.679783
7432,1,7432,174072198,256059356,0.679812
7442,1,7442,174079640,256059356,0.679841
7445,1,7445,174087085,256059356,0.67987
7455,1,7455,174094540,256059356,0.679899
7457,1,7457,174101997,256059356,0.679928
7463,1,7463,174109460,256059356,0.679957
7468,1,7468,174116928,256059356,0.679987
7471,1,7471,174124399,256059356,0.680016
7472,1,7472,174131871,256059356,0.680045
7483,1,7483,174139354,256059356,0.680074
7484,1,7484,174146838,256059356,0.680103
7487,1,7487,174154325,256059356,0.680133
7500,6,45000,174199325,256059356,0.680308
7502,1,7502,174206827,256059356,0.680338
7503,3,22509,174229336,256059356,0.680426
7507,1,7507,174236843,256059356,0.680455
7508,1,7508,174244351,256059356,0.680484
7514,1,7514,174251865,256059356,0.680514
7517,2,15034,174266899,256059356,0.680572
7519,2,15038,174281937,256059356,0.680631
7525,1,7525,174289462,256059356,0.68066
7527,1,7527,174296989,256059356,0.68069
7528,1,7528,174304517,256059356,0.680719
7539,1,7539,174312056,256059356,0.680749
7542,2,15084,174327140,256059356,0.680808
7543,3,22629,174349769,256059356,0.680896
7544,1,7544,174357313,256059356,0.680925
7545,3,22635,174379948,256059356,0.681014
7547,2,15094,174395042,256059356,0.681073
7548,1,7548,174402590,256059356,0.681102
7549,2,15098,174417688,256059356,0.681161
7550,1,7550,174425238,256059356,0.681191
7551,1,7551,174432789,256059356,0.68122
7552,1,7552,174440341,256059356,0.68125
7555,1,7555,174447896,256059356,0.681279
7556,3,22668,174470564,256059356,0.681368
7559,2,15118,174485682,256059356,0.681427
7560,1,7560,174493242,256059356,0.681456
7563,1,7563,174500805,256059356,0.681486
7564,1,7564,174508369,256059356,0.681515
7568,4,30272,174538641,256059356,0.681634
7569,6,45414,174584055,256059356,0.681811
7570,5,37850,174621905,256059356,0.681959
7571,1,7571,174629476,256059356,0.681988
7573,2,15146,174644622,256059356,0.682047
7574,2,15148,174659770,256059356,0.682107
7580,1,7580,174667350,256059356,0.682136
7581,1,7581,174674931,256059356,0.682166
7587,1,7587,174682518,256059356,0.682195
7596,1,7596,174690114,256059356,0.682225
7601,2,15202,174705316,256059356,0.682284
7604,2,15208,174720524,256059356,0.682344
7605,1,7605,174728129,256059356,0.682374
7606,1,7606,174735735,256059356,0.682403
7607,1,7607,174743342,256059356,0.682433
7613,1,7613,174750955,256059356,0.682463
7615,1,7615,174758570,256059356,0.682492
7635,1,7635,174766205,256059356,0.682522
7639,1,7639,174773844,256059356,0.682552
7645,1,7645,174781489,256059356,0.682582
7657,1,7657,174789146,256059356,0.682612
7666,1,7666,174796812,256059356,0.682642
7671,1,7671,174804483,256059356,0.682672
7673,1,7673,174812156,256059356,0.682702
7676,1,7676,174819832,256059356,0.682732
7677,2,15354,174835186,256059356,0.682792
7678,3,23034,174858220,256059356,0.682882
7688,1,7688,174865908,256059356,0.682912
7692,1,7692,174873600,256059356,0.682942
7713,1,7713,174881313,256059356,0.682972
7716,2,15432,174896745,256059356,0.683032
7732,1,7732,174904477,256059356,0.683062
7736,1,7736,174912213,256059356,0.683092
7742,1,7742,174919955,256059356,0.683123
7749,1,7749,174927704,256059356,0.683153
7750,1,7750,174935454,256059356,0.683183
7751,1,7751,174943205,256059356,0.683213
7752,1,7752,174950957,256059356,0.683244
7762,1,7762,174958719,256059356,0.683274
7768,1,7768,174966487,256059356,0.683304
7776,1,7776,174974263,256059356,0.683335
7793,1,7793,174982056,256059356,0.683365
7795,1,7795,174989851,256059356,0.683396
7804,1,7804,174997655,256059356,0.683426
7810,1,7810,175005465,256059356,0.683457
7837,1,7837,175013302,256059356,0.683487
7846,1,7846,175021148,256059356,0.683518
7850,1,7850,175028998,256059356,0.683549
7852,1,7852,175036850,256059356,0.683579
7868,1,7868,175044718,256059356,0.68361
7871,1,7871,175052589,256059356,0.683641
7881,1,7881,175060470,256059356,0.683671
7884,1,7884,175068354,256059356,0.683702
7885,1,7885,175076239,256059356,0.683733
7896,1,7896,175084135,256059356,0.683764
7901,1,7901,175092036,256059356,0.683795
7913,1,7913,175099949,256059356,0.683826
7928,1,7928,175107877,256059356,0.683857
7930,1,7930,175115807,256059356,0.683888
7934,1,7934,175123741,256059356,0.683919
7941,1,7941,175131682,256059356,0.68395
7943,1,7943,175139625,256059356,0.683981
7944,1,7944,175147569,256059356,0.684012
7946,1,7946,175155515,256059356,0.684043
7949,1,7949,175163464,256059356,0.684074
7951,1,7951,175171415,256059356,0.684105
7960,2,15920,175187335,256059356,0.684167
7963,1,7963,175195298,256059356,0.684198
7973,1,7973,175203271,256059356,0.684229
7982,1,7982,175211253,256059356,0.68426
7997,1,7997,175219250,256059356,0.684292
8000,1,8000,175227250,256059356,0.684323
8012,1,8012,175235262,256059356,0.684354
8013,1,8013,175243275,256059356,0.684385
8015,1,8015,175251290,256059356,0.684417
8016,1,8016,175259306,256059356,0.684448
8029,1,8029,175267335,256059356,0.684479
8035,1,8035,175275370,256059356,0.684511
8041,1,8041,175283411,256059356,0.684542
8042,1,8042,175291453,256059356,0.684574
8043,1,8043,175299496,256059356,0.684605
8045,1,8045,175307541,256059356,0.684636
8051,1,8051,175315592,256059356,0.684668
8062,1,8062,175323654,256059356,0.684699
8077,1,8077,175331731,256059356,0.684731
8090,1,8090,175339821,256059356,0.684762
8093,1,8093,175347914,256059356,0.684794
8096,1,8096,175356010,256059356,0.684826
8097,1,8097,175364107,256059356,0.684857
8100,1,8100,175372207,256059356,0.684889
8101,2,16202,175388409,256059356,0.684952
8104,1,8104,175396513,256059356,0.684984
8116,1,8116,175404629,256059356,0.685016
8117,2,16234,175420863,256059356,0.685079
8118,1,8118,175428981,256059356,0.685111
8122,1,8122,175437103,256059356,0.685142
8123,1,8123,175445226,256059356,0.685174
8124,1,8124,175453350,256059356,0.685206
8126,1,8126,175461476,256059356,0.685238
8127,1,8127,175469603,256059356,0.685269
8136,1,8136,175477739,256059356,0.685301
8137,1,8137,175485876,256059356,0.685333
8153,1,8153,175494029,256059356,0.685365
8155,1,8155,175502184,256059356,0.685396
8174,1,8174,175510358,256059356,0.685428
8178,1,8178,175518536,256059356,0.68546
8196,1,8196,175526732,256059356,0.685492
8216,1,8216,175534948,256059356,0.685524
8221,1,8221,175543169,256059356,0.685557
8225,1,8225,175551394,256059356,0.685589
8231,1,8231,175559625,256059356,0.685621
8233,2,16466,175576091,256059356,0.685685
8239,1,8239,175584330,256059356,0.685717
8248,1,8248,175592578,256059356,0.68575
8253,1,8253,175600831,256059356,0.685782
8267,1,8267,175609098,256059356,0.685814
8270,1,8270,175617368,256059356,0.685846
8288,1,8288,175625656,256059356,0.685879
8289,1,8289,175633945,256059356,0.685911
8297,1,8297,175642242,256059356,0.685943
8305,1,8305,175650547,256059356,0.685976
8307,1,8307,175658854,256059356,0.686008
8309,1,8309,175667163,256059356,0.686041
8313,2,16626,175683789,256059356,0.686106
8317,1,8317,175692106,256059356,0.686138
8318,1,8318,175700424,256059356,0.686171
8319,1,8319,175708743,256059356,0.686203
8325,1,8325,175717068,256059356,0.686236
8328,1,8328,175725396,256059356,0.686268
8329,2,16658,175742054,256059356,0.686333
8337,1,8337,175750391,256059356,0.686366
8340,1,8340,175758731,256059356,0.686398
8360,1,8360,175767091,256059356,0.686431
8364,1,8364,175775455,256059356,0.686464
8368,1,8368,175783823,256059356,0.686496
8376,1,8376,175792199,256059356,0.686529
8383,1,8383,175800582,256059356,0.686562
8387,1,8387,175808969,256059356,0.686595
8391,1,8391,175817360,256059356,0.686627
8392,1,8392,175825752,256059356,0.68666
8411,1,8411,175834163,256059356,0.686693
8412,1,8412,175842575,256059356,0.686726
8413,1,8413,175850988,256059356,0.686759
8418,1,8418,175859406,256059356,0.686792
8424,1,8424,175867830,256059356,0.686824
8436,1,8436,175876266,256059356,0.686857
8438,1,8438,175884704,256059356,0.68689
8443,1,8443,175893147,256059356,0.686923
8458,1,8458,175901605,256059356,0.686956
8472,1,8472,175910077,256059356,0.686989
8481,1,8481,175918558,256059356,0.687023
8497,1,8497,175927055,256059356,0.687056
8499,2,16998,175944053,256059356,0.687122
8505,1,8505,175952558,256059356,0.687155
8516,1,8516,175961074,256059356,0.687189
8519,1,8519,175969593,256059356,0.687222
8523,1,8523,175978116,256059356,0.687255
8533,1,8533,175986649,256059356,0.687288
8548,1,8548,175995197,256059356,0.687322
8549,1,8549,176003746,256059356,0.687355
8554,1,8554,176012300,256059356,0.687389
8555,1,8555,176020855,256059356,0.687422
8563,1,8563,176029418,256059356,0.687456
8566,2,17132,176046550,256059356,0.687522
8568,1,8568,176055118,256059356,0.687556
8575,1,8575,176063693,256059356,0.687589
8577,1,8577,176072270,256059356,0.687623
8580,1,8580,176080850,256059356,0.687656
8596,1,8596,176089446,256059356,0.68769
8600,1,8600,176098046,256059356,0.687724
8616,1,8616,176106662,256059356,0.687757
8622,1,8622,176115284,256059356,0.687791
8628,1,8628,176123912,256059356,0.687825
8647,1,8647,176132559,256059356,0.687858
8651,1,8651,176141210,256059356,0.687892
8660,1,8660,176149870,256059356,0.687926
8672,2,17344,176167214,256059356,0.687994
8698,2,17396,176184610,256059356,0.688062
8725,1,8725,176193335,256059356,0.688096
8737,1,8737,176202072,256059356,0.68813
8738,1,8738,176210810,256059356,0.688164
8740,1,8740,176219550,256059356,0.688198
8750,1,8750,176228300,256059356,0.688232
8757,1,8757,176237057,256059356,0.688266
8773,1,8773,176245830,256059356,0.688301
8783,1,8783,176254613,256059356,0.688335
8791,1,8791,176263404,256059356,0.688369
8800,1,8800,176272204,256059356,0.688404
8801,1,8801,176281005,256059356,0.688438
8811,1,8811,176289816,256059356,0.688472
8815,1,8815,176298631,256059356,0.688507
8821,1,8821,176307452,256059356,0.688541
8824,1,8824,176316276,256059356,0.688576
8836,1,8836,176325112,256059356,0.68861
8837,1,8837,176333949,256059356,0.688645
8842,1,8842,176342791,256059356,0.688679
8843,1,8843,176351634,256059356,0.688714
8847,1,8847,176360481,256059356,0.688748
8860,1,8860,176369341,256059356,0.688783
8861,1,8861,176378202,256059356,0.688818
8867,1,8867,176387069,256059356,0.688852
8871,2,17742,176404811,256059356,0.688922
8874,1,8874,176413685,256059356,0.688956
8891,1,8891,176422576,256059356,0.688991
8895,1,8895,176431471,256059356,0.689026
8900,1,8900,176440371,256059356,0.68906
8901,1,8901,176449272,256059356,0.689095
8904,1,8904,176458176,256059356,0.68913
8932,1,8932,176467108,256059356,0.689165
8933,2,17866,176484974,256059356,0.689235
8937,1,8937,176493911,256059356,0.68927
8940,2,17880,176511791,256059356,0.689339
8941,1,8941,176520732,256059356,0.689374
8970,1,8970,176529702,256059356,0.689409
8981,2,17962,176547664,256059356,0.689479
8983,1,8983,176556647,256059356,0.689515
8985,1,8985,176565632,256059356,0.68955
8989,1,8989,176574621,256059356,0.689585
8990,1,8990,176583611,256059356,0.68962
8991,1,8991,176592602,256059356,0.689655
8998,1,8998,176601600,256059356,0.68969
9013,2,18026,176619626,256059356,0.68976
9025,1,9025,176628651,256059356,0.689796
9029,1,9029,176637680,256059356,0.689831
9035,1,9035,176646715,256059356,0.689866
9036,1,9036,176655751,256059356,0.689902
9045,1,9045,176664796,256059356,0.689937
9050,1,9050,176673846,256059356,0.689972
9057,1,9057,176682903,256059356,0.690008
9064,1,9064,176691967,256059356,0.690043
9066,1,9066,176701033,256059356,0.690078
9067,1,9067,176710100,256059356,0.690114
9073,2,18146,176728246,256059356,0.690185
9082,2,18164,176746410,256059356,0.690256
9088,1,9088,176755498,256059356,0.690291
9090,1,9090,176764588,256059356,0.690327
9094,1,9094,176773682,256059356,0.690362
9108,1,9108,176782790,256059356,0.690398
9111,1,9111,176791901,256059356,0.690433
9114,1,9114,176801015,256059356,0.690469
9115,2,18230,176819245,256059356,0.69054
9123,2,18246,176837491,256059356,0.690611
9128,1,9128,176846619,256059356,0.690647
9130,2,18260,176864879,256059356,0.690718
9134,1,9134,176874013,256059356,0.690754
9135,1,9135,176883148,256059356,0.69079
9138,1,9138,176892286,256059356,0.690825
9142,1,9142,176901428,256059356,0.690861
9149,1,9149,176910577,256059356,0.690897
9150,2,18300,176928877,256059356,0.690968
9155,1,9155,176938032,256059356,0.691004
9157,1,9157,176947189,256059356,0.69104
9158,1,9158,176956347,256059356,0.691075
9161,1,9161,176965508,256059356,0.691111
9168,1,9168,176974676,256059356,0.691147
9181,1,9181,176983857,256059356,0.691183
9184,1,9184,176993041,256059356,0.691219
9185,1,9185,177002226,256059356,0.691255
9192,2,18384,177020610,256059356,0.691326
9208,1,9208,177029818,256059356,0.691362
9211,1,9211,177039029,256059356,0.691398
9218,1,9218,177048247,256059356,0.691434
9221,1,9221,177057468,256059356,0.69147
9224,1,9224,177066692,256059356,0.691506
9228,2,18456,177085148,256059356,0.691579
9232,1,9232,177094380,256059356,0.691615
9233,1,9233,177103613,256059356,0.691651
9235,1,9235,177112848,256059356,0.691687
9239,1,9239,177122087,256059356,0.691723
9243,1,9243,177131330,256059356,0.691759
9246,1,9246,177140576,256059356,0.691795
9252,1,9252,177149828,256059356,0.691831
9257,1,9257,177159085,256059356,0.691867
9261,1,9261,177168346,256059356,0.691903
9268,1,9268,177177614,256059356,0.69194
9272,1,9272,177186886,256059356,0.691976
9288,1,9288,177196174,256059356,0.692012
9289,1,9289,177205463,256059356,0.692048
9293,1,9293,177214756,256059356,0.692085
9297,1,9297,177224053,256059356,0.692121
9317,1,9317,177233370,256059356,0.692157
9327,1,9327,177242697,256059356,0.692194
9330,1,9330,177252027,256059356,0.69223
9331,1,9331,177261358,256059356,0.692267
9336,1,9336,177270694,256059356,0.692303
9338,1,9338,177280032,256059356,0.69234
9346,1,9346,177289378,256059356,0.692376
9366,2,18732,177308110,256059356,0.692449
9376,1,9376,177317486,256059356,0.692486
9383,1,9383,177326869,256059356,0.692523
9388,1,9388,177336257,256059356,0.692559
9393,1,9393,177345650,256059356,0.692596
9398,1,9398,177355048,256059356,0.692633
9404,1,9404,177364452,256059356,0.692669
9410,1,9410,177373862,256059356,0.692706
9418,1,9418,177383280,256059356,0.692743
9428,1,9428,177392708,256059356,0.69278
9429,1,9429,177402137,256059356,0.692816
9432,1,9432,177411569,256059356,0.692853
9435,1,9435,177421004,256059356,0.69289
9437,1,9437,177430441,256059356,0.692927
9442,2,18884,177449325,256059356,0.693001
9445,1,9445,177458770,256059356,0.693038
9459,1,9459,177468229,256059356,0.693075
9460,1,9460,177477689,256059356,0.693112
9465,1,9465,177487154,256059356,0.693148
9474,1,9474,177496628,256059356,0.693185
9477,1,9477,177506105,256059356,0.693222
9482,1,9482,177515587,256059356,0.69326
9483,1,9483,177525070,256059356,0.693297
9486,1,9486,177534556,256059356,0.693334
9487,1,9487,177544043,256059356,0.693371
9488,1,9488,177553531,256059356,0.693408
9506,1,9506,177563037,256059356,0.693445
9509,1,9509,177572546,256059356,0.693482
9510,1,9510,177582056,256059356,0.693519
9514,1,9514,177591570,256059356,0.693556
9525,1,9525,177601095,256059356,0.693593
9530,1,9530,177610625,256059356,0.693631
9545,1,9545,177620170,256059356,0.693668
9546,1,9546,177629716,256059356,0.693705
9552,1,9552,177639268,256059356,0.693743
9553,2,19106,177658374,256059356,0.693817
9556,1,9556,177667930,256059356,0.693854
9567,1,9567,177677497,256059356,0.693892
9568,1,9568,177687065,256059356,0.693929
9591,2,19182,177706247,256059356,0.694004
9593,2,19186,177725433,256059356,0.694079
9594,1,9594,177735027,256059356,0.694117
9596,2,19192,177754219,256059356,0.694191
9598,2,19196,177773415,256059356,0.694266
9605,1,9605,177783020,256059356,0.694304
9606,1,9606,177792626,256059356,0.694341
9611,1,9611,177802237,256059356,0.694379
9614,2,19228,177821465,256059356,0.694454
9618,1,9618,177831083,256059356,0.694492
9627,1,9627,177840710,256059356,0.694529
9646,1,9646,177850356,256059356,0.694567
9655,1,9655,177860011,256059356,0.694605
9660,1,9660,177869671,256059356,0.694642
9665,1,9665,177879336,256059356,0.69468
9681,1,9681,177889017,256059356,0.694718
9682,1,9682,177898699,256059356,0.694756
9685,1,9685,177908384,256059356,0.694794
9690,1,9690,177918074,256059356,0.694831
9692,2,19384,177937458,256059356,0.694907
9696,1,9696,177947154,256059356,0.694945
9700,2,19400,177966554,256059356,0.695021
9704,1,9704,177976258,256059356,0.695059
9708,1,9708,177985966,256059356,0.695097
9714,2,19428,178005394,256059356,0.695172
9715,3,29145,178034539,256059356,0.695286
9717,1,9717,178044256,256059356,0.695324
9719,1,9719,178053975,256059356,0.695362
9720,1,9720,178063695,256059356,0.6954
9722,1,9722,178073417,256059356,0.695438
9723,1,9723,178083140,256059356,0.695476
9724,1,9724,178092864,256059356,0.695514
9725,2,19450,178112314,256059356,0.69559
9727,1,9727,178122041,256059356,0.695628
9730,2,19460,178141501,256059356,0.695704
9735,1,9735,178151236,256059356,0.695742
9737,1,9737,178160973,256059356,0.69578
9738,1,9738,178170711,256059356,0.695818
9739,1,9739,178180450,256059356,0.695856
9740,1,9740,178190190,256059356,0.695894
9744,1,9744,178199934,256059356,0.695932
9754,1,9754,178209688,256059356,0.69597
9758,1,9758,178219446,256059356,0.696008
9778,1,9778,178229224,256059356,0.696047
9779,1,9779,178239003,256059356,0.696085
9788,1,9788,178248791,256059356,0.696123
9796,1,9796,178258587,256059356,0.696161
9798,1,9798,178268385,256059356,0.696199
9806,1,9806,178278191,256059356,0.696238
9808,1,9808,178287999,256059356,0.696276
9813,1,9813,178297812,256059356,0.696314
9817,1,9817,178307629,256059356,0.696353
9821,1,9821,178317450,256059356,0.696391
9823,1,9823,178327273,256059356,0.696429
9826,2,19652,178346925,256059356,0.696506
9829,1,9829,178356754,256059356,0.696545
9833,1,9833,178366587,256059356,0.696583
9835,1,9835,178376422,256059356,0.696621
9842,1,9842,178386264,256059356,0.69666
9847,1,9847,178396111,256059356,0.696698
9853,1,9853,178405964,256059356,0.696737
9864,1,9864,178415828,256059356,0.696775
9865,2,19730,178435558,256059356,0.696852
9867,1,9867,178445425,256059356,0.696891
9871,1,9871,178455296,256059356,0.696929
9873,1,9873,178465169,256059356,0.696968
9874,1,9874,178475043,256059356,0.697007
9876,1,9876,178484919,256059356,0.697045
9880,1,9880,178494799,256059356,0.697084
9881,1,9881,178504680,256059356,0.697122
9885,1,9885,178514565,256059356,0.697161
9891,1,9891,178524456,256059356,0.6972
9893,1,9893,178534349,256059356,0.697238
9896,1,9896,178544245,256059356,0.697277
9897,1,9897,178554142,256059356,0.697315
9898,1,9898,178564040,256059356,0.697354
9905,1,9905,178573945,256059356,0.697393
9913,1,9913,178583858,256059356,0.697431
9915,1,9915,178593773,256059356,0.69747
9916,1,9916,178603689,256059356,0.697509
9920,2,19840,178623529,256059356,0.697586
9924,1,9924,178633453,256059356,0.697625
9925,1,9925,178643378,256059356,0.697664
9929,1,9929,178653307,256059356,0.697703
9930,1,9930,178663237,256059356,0.697741
9931,1,9931,178673168,256059356,0.69778
9932,1,9932,178683100,256059356,0.697819
9935,1,9935,178693035,256059356,0.697858
9936,1,9936,178702971,256059356,0.697897
9938,2,19876,178722847,256059356,0.697974
9940,1,9940,178732787,256059356,0.698013
9946,1,9946,178742733,256059356,0.698052
9948,1,9948,178752681,256059356,0.698091
9949,1,9949,178762630,256059356,0.69813
9951,1,9951,178772581,256059356,0.698169
9954,1,9954,178782535,256059356,0.698207
9955,2,19910,178802445,256059356,0.698285
9956,2,19912,178822357,256059356,0.698363
9957,1,9957,178832314,256059356,0.698402
9958,1,9958,178842272,256059356,0.698441
9960,1,9960,178852232,256059356,0.69848
9963,1,9963,178862195,256059356,0.698518
9964,2,19928,178882123,256059356,0.698596
9966,1,9966,178892089,256059356,0.698635
9967,1,9967,178902056,256059356,0.698674
9968,2,19936,178921992,256059356,0.698752
9973,1,9973,178931965,256059356,0.698791
9981,2,19962,178951927,256059356,0.698869
9982,5,49910,179001837,256059356,0.699064
9983,4,39932,179041769,256059356,0.69922
9984,8,79872,179121641,256059356,0.699532
9985,4,39940,179161581,256059356,0.699688
9986,4,39944,179201525,256059356,0.699844
9987,4,39948,179241473,256059356,0.7
9989,2,19978,179261451,256059356,0.700078
9990,2,19980,179281431,256059356,0.700156
9991,2,19982,179301413,256059356,0.700234
9992,3,29976,179331389,256059356,0.700351
9993,1,9993,179341382,256059356,0.70039
9994,3,29982,179371364,256059356,0.700507
9995,1,9995,179381359,256059356,0.700546
9997,1,9997,179391356,256059356,0.700585
9999,2,19998,179411354,256059356,0.700663
10000,9,90000,179501354,256059356,0.701015
10001,6,60006,179561360,256059356,0.701249
10002,2,20004,179581364,256059356,0.701327
10003,5,50015,179631379,256059356,0.701522
10004,3,30012,179661391,256059356,0.70164
10005,4,40020,179701411,256059356,0.701796
10006,3,30018,179731429,256059356,0.701913
10007,5,50035,179781464,256059356,0.702109
10008,7,70056,179851520,256059356,0.702382
10009,1,10009,179861529,256059356,0.702421
10010,8,80080,179941609,256059356,0.702734
10011,4,40044,179981653,256059356,0.70289
10012,2,20024,180001677,256059356,0.702969
10013,2,20026,180021703,256059356,0.703047
10014,3,30042,180051745,256059356,0.703164
10015,3,30045,180081790,256059356,0.703281
10016,4,40064,180121854,256059356,0.703438
10018,7,70126,180191980,256059356,0.703712
10019,1,10019,180201999,256059356,0.703751
10020,5,50100,180252099,256059356,0.703947
10022,4,40088,180292187,256059356,0.704103
10023,4,40092,180332279,256059356,0.70426
10024,4,40096,180372375,256059356,0.704416
10025,3,30075,180402450,256059356,0.704534
10026,2,20052,180422502,256059356,0.704612
10027,4,40108,180462610,256059356,0.704769
10028,3,30084,180492694,256059356,0.704886
10029,2,20058,180512752,256059356,0.704964
10030,1,10030,180522782,256059356,0.705004
10031,2,20062,180542844,256059356,0.705082
10032,1,10032,180552876,256059356,0.705121
10035,2,20070,180572946,256059356,0.7052
10036,2,20072,180593018,256059356,0.705278
10039,1,10039,180603057,256059356,0.705317
10041,2,20082,180623139,256059356,0.705396
10042,2,20084,180643223,256059356,0.705474
10043,2,20086,180663309,256059356,0.705552
10044,1,10044,180673353,256059356,0.705592
10047,1,10047,180683400,256059356,0.705631
10049,1,10049,180693449,256059356,0.70567
10050,1,10050,180703499,256059356,0.705709
10051,1,10051,180713550,256059356,0.705749
10053,1,10053,180723603,256059356,0.705788
10055,1,10055,180733658,256059356,0.705827
10056,1,10056,180743714,256059356,0.705866
10057,1,10057,180753771,256059356,0.705906
10058,2,20116,180773887,256059356,0.705984
10059,1,10059,180783946,256059356,0.706024
10063,2,20126,180804072,256059356,0.706102
10065,1,10065,180814137,256059356,0.706141
10067,1,10067,180824204,256059356,0.706181
10068,1,10068,180834272,256059356,0.70622
10070,1,10070,180844342,256059356,0.706259
10073,1,10073,180854415,256059356,0.706299
10075,1,10075,180864490,256059356,0.706338
10077,1,10077,180874567,256059356,0.706377
10080,1,10080,180884647,256059356,0.706417
10084,1,10084,180894731,256059356,0.706456
10085,1,10085,180904816,256059356,0.706496
10088,1,10088,180914904,256059356,0.706535
10089,1,10089,180924993,256059356,0.706574
10091,2,20182,180945175,256059356,0.706653
10092,1,10092,180955267,256059356,0.706693
10095,2,20190,180975457,256059356,0.706772
10096,2,20192,180995649,256059356,0.70685
10097,1,10097,181005746,256059356,0.70689
10098,1,10098,181015844,256059356,0.706929
10100,1,10100,181025944,256059356,0.706969
10102,1,10102,181036046,256059356,0.707008
10105,1,10105,181046151,256059356,0.707048
10108,2,20216,181066367,256059356,0.707127
10109,1,10109,181076476,256059356,0.707166
10111,1,10111,181086587,256059356,0.707206
10112,1,10112,181096699,256059356,0.707245
10114,1,10114,181106813,256059356,0.707284
10116,1,10116,181116929,256059356,0.707324
10117,1,10117,181127046,256059356,0.707364
10118,1,10118,181137164,256059356,0.707403
10120,1,10120,181147284,256059356,0.707443
10125,1,10125,181157409,256059356,0.707482
10126,1,10126,181167535,256059356,0.707522
10127,1,10127,181177662,256059356,0.707561
10128,1,10128,181187790,256059356,0.707601
10130,2,20260,181208050,256059356,0.70768
10131,1,10131,181218181,256059356,0.707719
10132,1,10132,181228313,256059356,0.707759
10141,1,10141,181238454,256059356,0.707799
10144,1,10144,181248598,256059356,0.707838
10146,1,10146,181258744,256059356,0.707878
10148,1,10148,181268892,256059356,0.707917
10149,1,10149,181279041,256059356,0.707957
10157,1,10157,181289198,256059356,0.707997
10161,1,10161,181299359,256059356,0.708036
10162,2,20324,181319683,256059356,0.708116
10163,1,10163,181329846,256059356,0.708156
10172,1,10172,181340018,256059356,0.708195
10178,1,10178,181350196,256059356,0.708235
10182,1,10182,181360378,256059356,0.708275
10187,1,10187,181370565,256059356,0.708315
10210,2,20420,181390985,256059356,0.708394
10213,1,10213,181401198,256059356,0.708434
10215,1,10215,181411413,256059356,0.708474
10226,1,10226,181421639,256059356,0.708514
10227,1,10227,181431866,256059356,0.708554
10228,1,10228,181442094,256059356,0.708594
10229,2,20458,181462552,256059356,0.708674
10230,1,10230,181472782,256059356,0.708714
10231,1,10231,181483013,256059356,0.708754
10233,1,10233,181493246,256059356,0.708794
10234,1,10234,181503480,256059356,0.708834
10236,1,10236,181513716,256059356,0.708874
10248,1,10248,181523964,256059356,0.708914
10249,1,10249,181534213,256059356,0.708954
10253,1,10253,181544466,256059356,0.708994
10259,1,10259,181554725,256059356,0.709034
10261,1,10261,181564986,256059356,0.709074
10262,1,10262,181575248,256059356,0.709114
10266,1,10266,181585514,256059356,0.709154
10267,1,10267,181595781,256059356,0.709194
10276,1,10276,181606057,256059356,0.709234
10278,1,10278,181616335,256059356,0.709274
10280,1,10280,181626615,256059356,0.709315
10282,3,30846,181657461,256059356,0.709435
10286,1,10286,181667747,256059356,0.709475
10296,1,10296,181678043,256059356,0.709515
10304,1,10304,181688347,256059356,0.709556
10322,1,10322,181698669,256059356,0.709596
10333,1,10333,181709002,256059356,0.709636
10354,2,20708,181729710,256059356,0.709717
10373,1,10373,181740083,256059356,0.709758
10376,1,10376,181750459,256059356,0.709798
10385,1,10385,181760844,256059356,0.709839
10393,1,10393,181771237,256059356,0.709879
10397,1,10397,181781634,256059356,0.70992
10400,1,10400,181792034,256059356,0.709961
10404,2,20808,181812842,256059356,0.710042
10407,1,10407,181823249,256059356,0.710082
10418,1,10418,181833667,256059356,0.710123
10419,1,10419,181844086,256059356,0.710164
10422,1,10422,181854508,256059356,0.710205
10430,2,20860,181875368,256059356,0.710286
10432,1,10432,181885800,256059356,0.710327
10440,1,10440,181896240,256059356,0.710367
10464,1,10464,181906704,256059356,0.710408
10467,1,10467,181917171,256059356,0.710449
10476,1,10476,181927647,256059356,0.71049
10477,1,10477,181938124,256059356,0.710531
10485,1,10485,181948609,256059356,0.710572
10496,1,10496,181959105,256059356,0.710613
10501,1,10501,181969606,256059356,0.710654
10517,1,10517,181980123,256059356,0.710695
10533,1,10533,181990656,256059356,0.710736
10557,1,10557,182001213,256059356,0.710777
10564,2,21128,182022341,256059356,0.71086
10568,1,10568,182032909,256059356,0.710901
10569,1,10569,182043478,256059356,0.710942
10571,2,21142,182064620,256059356,0.711025
10590,1,10590,182075210,256059356,0.711066
10597,1,10597,182085807,256059356,0.711108
10615,1,10615,182096422,256059356,0.711149
10616,1,10616,182107038,256059356,0.711191
10623,1,10623,182117661,256059356,0.711232
10630,2,21260,182138921,256059356,0.711315
10632,1,10632,182149553,256059356,0.711357
10634,1,10634,182160187,256059356,0.711398
10645,1,10645,182170832,256059356,0.71144
10646,1,10646,182181478,256059356,0.711481
10661,1,10661,182192139,256059356,0.711523
10670,1,10670,182202809,256059356,0.711565
10683,1,10683,182213492,256059356,0.711606
10704,1,10704,182224196,256059356,0.711648
10710,1,10710,182234906,256059356,0.71169
10713,1,10713,182245619,256059356,0.711732
10722,2,21444,182267063,256059356,0.711816
10726,1,10726,182277789,256059356,0.711858
10750,1,10750,182288539,256059356,0.7119
10751,1,10751,182299290,256059356,0.711942
10754,1,10754,182310044,256059356,0.711984
10756,1,10756,182320800,256059356,0.712026
10766,1,10766,182331566,256059356,0.712068
10770,1,10770,182342336,256059356,0.71211
10771,1,10771,182353107,256059356,0.712152
10774,1,10774,182363881,256059356,0.712194
10779,1,10779,182374660,256059356,0.712236
10787,2,21574,182396234,256059356,0.71232
10793,1,10793,182407027,256059356,0.712362
10802,1,10802,182417829,256059356,0.712404
10807,1,10807,182428636,256059356,0.712447
10813,1,10813,182439449,256059356,0.712489
10817,1,10817,182450266,256059356,0.712531
10820,1,10820,182461086,256059356,0.712573
10831,1,10831,182471917,256059356,0.712616
10846,1,10846,182482763,256059356,0.712658
10847,1,10847,182493610,256059356,0.7127
10854,1,10854,182504464,256059356,0.712743
10861,1,10861,182515325,256059356,0.712785
10883,1,10883,182526208,256059356,0.712828
10895,1,10895,182537103,256059356,0.71287
10898,1,10898,182548001,256059356,0.712913
10902,1,10902,182558903,256059356,0.712955
10915,1,10915,182569818,256059356,0.712998
10916,1,10916,182580734,256059356,0.713041
10920,1,10920,182591654,256059356,0.713083
10930,1,10930,182602584,256059356,0.713126
10958,1,10958,182613542,256059356,0.713169
10962,1,10962,182624504,256059356,0.713212
10963,1,10963,182635467,256059356,0.713254
10968,1,10968,182646435,256059356,0.713297
10998,1,10998,182657433,256059356,0.71334
11010,1,11010,182668443,256059356,0.713383
11024,1,11024,182679467,256059356,0.713426
11045,1,11045,182690512,256059356,0.713469
11072,1,11072,182701584,256059356,0.713513
11093,1,11093,182712677,256059356,0.713556
11100,1,11100,182723777,256059356,0.713599
11104,1,11104,182734881,256059356,0.713643
11111,1,11111,182745992,256059356,0.713686
11112,1,11112,182757104,256059356,0.713729
11128,1,11128,182768232,256059356,0.713773
11131,1,11131,182779363,256059356,0.713816
11133,1,11133,182790496,256059356,0.71386
11144,1,11144,182801640,256059356,0.713903
11159,1,11159,182812799,256059356,0.713947
11195,1,11195,182823994,256059356,0.713991
11254,1,11254,182835248,256059356,0.714035
11268,1,11268,182846516,256059356,0.714079
11317,1,11317,182857833,256059356,0.714123
11318,1,11318,182869151,256059356,0.714167
11326,1,11326,182880477,256059356,0.714211
11348,1,11348,182891825,256059356,0.714256
11352,1,11352,182903177,256059356,0.7143
11355,1,11355,182914532,256059356,0.714344
11357,1,11357,182925889,256059356,0.714389
11410,1,11410,182937299,256059356,0.714433
11420,1,11420,182948719,256059356,0.714478
11421,1,11421,182960140,256059356,0.714522
11453,1,11453,182971593,256059356,0.714567
11458,1,11458,182983051,256059356,0.714612
11466,1,11466,182994517,256059356,0.714657
11491,1,11491,183006008,256059356,0.714702
11497,1,11497,183017505,256059356,0.714746
11499,1,11499,183029004,256059356,0.714791
11524,1,11524,183040528,256059356,0.714836
11526,1,11526,183052054,256059356,0.714881
11527,1,11527,183063581,256059356,0.714926
11546,1,11546,183075127,256059356,0.714971
11555,1,11555,183086682,256059356,0.715017
11576,1,11576,183098258,256059356,0.715062
11582,1,11582,183109840,256059356,0.715107
11618,1,11618,183121458,256059356,0.715152
11627,1,11627,183133085,256059356,0.715198
11636,1,11636,183144721,256059356,0.715243
11645,1,11645,183156366,256059356,0.715289
11659,1,11659,183168025,256059356,0.715334
11663,1,11663,183179688,256059356,0.71538
11669,1,11669,183191357,256059356,0.715425
11691,1,11691,183203048,256059356,0.715471
11693,1,11693,183214741,256059356,0.715517
11717,1,11717,183226458,256059356,0.715562
11718,1,11718,183238176,256059356,0.715608
11741,1,11741,183249917,256059356,0.715654
11744,1,11744,183261661,256059356,0.7157
11756,1,11756,183273417,256059356,0.715746
11778,1,11778,183285195,256059356,0.715792
11789,1,11789,183296984,256059356,0.715838
11805,1,11805,183308789,256059356,0.715884
11868,1,11868,183320657,256059356,0.71593
11886,1,11886,183332543,256059356,0.715977
11887,1,11887,183344430,256059356,0.716023
11942,1,11942,183356372,256059356,0.71607
11943,1,11943,183368315,256059356,0.716116
11949,1,11949,183380264,256059356,0.716163
11966,1,11966,183392230,256059356,0.71621
11993,1,11993,183404223,256059356,0.716257
12008,1,12008,183416231,256059356,0.716304
12014,1,12014,183428245,256059356,0.71635
12054,1,12054,183440299,256059356,0.716398
12066,1,12066,183452365,256059356,0.716445
12069,1,12069,183464434,256059356,0.716492
12073,1,12073,183476507,256059356,0.716539
12074,1,12074,183488581,256059356,0.716586
12153,1,12153,183500734,256059356,0.716634
12167,2,24334,183525068,256059356,0.716729
12178,1,12178,183537246,256059356,0.716776
12185,1,12185,183549431,256059356,0.716824
12197,1,12197,183561628,256059356,0.716871
12221,1,12221,183573849,256059356,0.716919
12260,1,12260,183586109,256059356,0.716967
12264,1,12264,183598373,256059356,0.717015
12266,1,12266,183610639,256059356,0.717063
12286,1,12286,183622925,256059356,0.717111
12321,1,12321,183635246,256059356,0.717159
12339,1,12339,183647585,256059356,0.717207
12345,1,12345,183659930,256059356,0.717255
12347,1,12347,183672277,256059356,0.717304
12350,1,12350,183684627,256059356,0.717352
12367,1,12367,183696994,256059356,0.7174
12393,1,12393,183709387,256059356,0.717448
12400,1,12400,183721787,256059356,0.717497
12412,1,12412,183734199,256059356,0.717545
12414,1,12414,183746613,256059356,0.717594
12415,1,12415,183759028,256059356,0.717642
12447,1,12447,183771475,256059356,0.717691
12467,1,12467,183783942,256059356,0.71774
12480,1,12480,183796422,256059356,0.717788
12523,1,12523,183808945,256059356,0.717837
12532,1,12532,183821477,256059356,0.717886
12593,7,88151,183909628,256059356,0.71823
12594,1,12594,183922222,256059356,0.71828
12595,1,12595,183934817,256059356,0.718329
12609,1,12609,183947426,256059356,0.718378
12614,1,12614,183960040,256059356,0.718427
12642,1,12642,183972682,256059356,0.718477
12656,1,12656,183985338,256059356,0.718526
12665,1,12665,183998003,256059356,0.718576
12681,1,12681,184010684,256059356,0.718625
12711,1,12711,184023395,256059356,0.718675
12732,1,12732,184036127,256059356,0.718724
12763,1,12763,184048890,256059356,0.718774
12764,1,12764,184061654,256059356,0.718824
12772,1,12772,184074426,256059356,0.718874
12773,1,12773,184087199,256059356,0.718924
12809,1,12809,184100008,256059356,0.718974
12821,1,12821,184112829,256059356,0.719024
12842,1,12842,184125671,256059356,0.719074
12850,1,12850,184138521,256059356,0.719124
12881,1,12881,184151402,256059356,0.719175
12892,1,12892,184164294,256059356,0.719225
12906,1,12906,184177200,256059356,0.719275
12908,1,12908,184190108,256059356,0.719326
12926,1,12926,184203034,256059356,0.719376
12929,1,12929,184215963,256059356,0.719427
12955,1,12955,184228918,256059356,0.719477
12969,1,12969,184241887,256059356,0.719528
13016,1,13016,184254903,256059356,0.719579
13025,1,13025,184267928,256059356,0.71963
13033,1,13033,184280961,256059356,0.719681
13067,1,13067,184294028,256059356,0.719732
13068,1,13068,184307096,256059356,0.719783
13103,1,13103,184320199,256059356,0.719834
13125,1,13125,184333324,256059356,0.719885
13139,1,13139,184346463,256059356,0.719936
13169,1,13169,184359632,256059356,0.719988
13200,1,13200,184372832,256059356,0.720039
13226,1,13226,184386058,256059356,0.720091
13231,1,13231,184399289,256059356,0.720143
13251,1,13251,184412540,256059356,0.720195
13263,1,13263,184425803,256059356,0.720246
13265,1,13265,184439068,256059356,0.720298
13267,1,13267,184452335,256059356,0.72035
13282,1,13282,184465617,256059356,0.720402
13304,1,13304,184478921,256059356,0.720454
13316,1,13316,184492237,256059356,0.720506
13321,1,13321,184505558,256059356,0.720558
13325,1,13325,184518883,256059356,0.72061
13331,1,13331,184532214,256059356,0.720662
13338,1,13338,184545552,256059356,0.720714
13361,1,13361,184558913,256059356,0.720766
13365,1,13365,184572278,256059356,0.720818
13369,1,13369,184585647,256059356,0.720871
13390,1,13390,184599037,256059356,0.720923
13408,1,13408,184612445,256059356,0.720975
13539,1,13539,184625984,256059356,0.721028
13543,1,13543,184639527,256059356,0.721081
13545,1,13545,184653072,256059356,0.721134
13555,1,13555,184666627,256059356,0.721187
13591,1,13591,184680218,256059356,0.72124
13620,1,13620,184693838,256059356,0.721293
13629,1,13629,184707467,256059356,0.721346
13696,1,13696,184721163,256059356,0.7214
13705,1,13705,184734868,256059356,0.721453
13707,1,13707,184748575,256059356,0.721507
13709,1,13709,184762284,256059356,0.72156
13742,2,27484,184789768,256059356,0.721668
13762,1,13762,184803530,256059356,0.721721
13764,1,13764,184817294,256059356,0.721775
13767,2,27534,184844828,256059356,0.721883
13810,1,13810,184858638,256059356,0.721937
13840,1,13840,184872478,256059356,0.721991
13849,1,13849,184886327,256059356,0.722045
13858,1,13858,184900185,256059356,0.722099
13899,1,13899,184914084,256059356,0.722153
13920,1,13920,184928004,256059356,0.722208
13935,1,13935,184941939,256059356,0.722262
13966,1,13966,184955905,256059356,0.722317
14040,1,14040,184969945,256059356,0.722371
14050,1,14050,184983995,256059356,0.722426
14117,1,14117,184998112,256059356,0.722481
14147,1,14147,185012259,256059356,0.722537
14229,1,14229,185026488,256059356,0.722592
14239,1,14239,185040727,256059356,0.722648
14266,1,14266,185054993,256059356,0.722704
14337,1,14337,185069330,256059356,0.722759
14350,1,14350,185083680,256059356,0.722816
14351,1,14351,185098031,256059356,0.722872
14374,1,14374,185112405,256059356,0.722928
14399,1,14399,185126804,256059356,0.722984
14437,1,14437,185141241,256059356,0.72304
14452,1,14452,185155693,256059356,0.723097
14454,1,14454,185170147,256059356,0.723153
14464,1,14464,185184611,256059356,0.72321
14474,1,14474,185199085,256059356,0.723266
14486,1,14486,185213571,256059356,0.723323
14497,1,14497,185228068,256059356,0.723379
14514,1,14514,185242582,256059356,0.723436
14567,1,14567,185257149,256059356,0.723493
14584,1,14584,185271733,256059356,0.72355
14591,1,14591,185286324,256059356,0.723607
14594,1,14594,185300918,256059356,0.723664
14596,1,14596,185315514,256059356,0.723721
14609,1,14609,185330123,256059356,0.723778
14634,1,14634,185344757,256059356,0.723835
14695,1,14695,185359452,256059356,0.723893
14701,1,14701,185374153,256059356,0.72395
14708,1,14708,185388861,256059356,0.724007
14733,1,14733,185403594,256059356,0.724065
14737,1,14737,185418331,256059356,0.724122
14758,1,14758,185433089,256059356,0.72418
14818,1,14818,185447907,256059356,0.724238
14830,1,14830,185462737,256059356,0.724296
14883,1,14883,185477620,256059356,0.724354
14889,1,14889,185492509,256059356,0.724412
14893,1,14893,185507402,256059356,0.72447
14897,1,14897,185522299,256059356,0.724528
14909,1,14909,185537208,256059356,0.724587
14921,1,14921,185552129,256059356,0.724645
15004,1,15004,185567133,256059356,0.724704
15039,1,15039,185582172,256059356,0.724762
15093,1,15093,185597265,256059356,0.724821
15132,1,15132,185612397,256059356,0.72488
15157,1,15157,185627554,256059356,0.72494
15213,1,15213,185642767,256059356,0.724999
15275,1,15275,185658042,256059356,0.725059
15300,1,15300,185673342,256059356,0.725118
15306,1,15306,185688648,256059356,0.725178
15323,1,15323,185703971,256059356,0.725238
15339,1,15339,185719310,256059356,0.725298
15342,1,15342,185734652,256059356,0.725358
15343,1,15343,185749995,256059356,0.725418
15346,2,30692,185780687,256059356,0.725538
15383,1,15383,185796070,256059356,0.725598
15406,1,15406,185811476,256059356,0.725658
15528,1,15528,185827004,256059356,0.725718
15533,1,15533,185842537,256059356,0.725779
15547,1,15547,185858084,256059356,0.72584
15559,1,15559,185873643,256059356,0.725901
15580,1,15580,185889223,256059356,0.725961
15634,1,15634,185904857,256059356,0.726023
15653,1,15653,185920510,256059356,0.726084
15678,1,15678,185936188,256059356,0.726145
15701,1,15701,185951889,256059356,0.726206
15712,1,15712,185967601,256059356,0.726268
15753,1,15753,185983354,256059356,0.726329
15783,14,220962,186204316,256059356,0.727192
15785,1,15785,186220101,256059356,0.727254
15788,1,15788,186235889,256059356,0.727315
15789,3,47367,186283256,256059356,0.7275
15795,1,15795,186299051,256059356,0.727562
15802,2,31604,186330655,256059356,0.727685
15804,1,15804,186346459,256059356,0.727747
15824,1,15824,186362283,256059356,0.727809
15847,1,15847,186378130,256059356,0.727871
15855,1,15855,186393985,256059356,0.727933
15873,1,15873,186409858,256059356,0.727995
15956,1,15956,186425814,256059356,0.728057
15981,1,15981,186441795,256059356,0.728119
15993,1,15993,186457788,256059356,0.728182
16104,1,16104,186473892,256059356,0.728245
16151,1,16151,186490043,256059356,0.728308
16152,1,16152,186506195,256059356,0.728371
16172,2,32344,186538539,256059356,0.728497
16231,1,16231,186554770,256059356,0.728561
16249,1,16249,186571019,256059356,0.728624
16257,1,16257,186587276,256059356,0.728688
16280,1,16280,186603556,256059356,0.728751
16321,1,16321,186619877,256059356,0.728815
16349,1,16349,186636226,256059356,0.728879
16371,1,16371,186652597,256059356,0.728943
16384,1,16384,186668981,256059356,0.729007
16397,1,16397,186685378,256059356,0.729071
16398,1,16398,186701776,256059356,0.729135
16410,1,16410,186718186,256059356,0.729199
16412,1,16412,186734598,256059356,0.729263
16417,1,16417,186751015,256059356,0.729327
16547,1,16547,186767562,256059356,0.729392
16549,1,16549,186784111,256059356,0.729456
16644,1,16644,186800755,256059356,0.729521
16674,1,16674,186817429,256059356,0.729586
16720,1,16720,186834149,256059356,0.729652
16758,1,16758,186850907,256059356,0.729717
16773,1,16773,186867680,256059356,0.729783
16825,1,16825,186884505,256059356,0.729848
16937,1,16937,186901442,256059356,0.729915
16971,1,16971,186918413,256059356,0.729981
16980,1,16980,186935393,256059356,0.730047
16984,1,16984,186952377,256059356,0.730113
16991,1,16991,186969368,256059356,0.73018
17000,1,17000,186986368,256059356,0.730246
17079,1,17079,187003447,256059356,0.730313
17124,1,17124,187020571,256059356,0.73038
17125,1,17125,187037696,256059356,0.730447
17128,2,34256,187071952,256059356,0.73058
17141,1,17141,187089093,256059356,0.730647
17157,1,17157,187106250,256059356,0.730714
17228,1,17228,187123478,256059356,0.730782
17363,1,17363,187140841,256059356,0.730849
17387,1,17387,187158228,256059356,0.730917
17391,1,17391,187175619,256059356,0.730985
17415,1,17415,187193034,256059356,0.731053
17430,1,17430,187210464,256059356,0.731121
17471,1,17471,187227935,256059356,0.73119
17477,1,17477,187245412,256059356,0.731258
17500,1,17500,187262912,256059356,0.731326
17534,1,17534,187280446,256059356,0.731395
17672,1,17672,187298118,256059356,0.731464
17746,1,17746,187315864,256059356,0.731533
17801,1,17801,187333665,256059356,0.731603
17898,1,17898,187351563,256059356,0.731672
17916,1,17916,187369479,256059356,0.731742
17929,1,17929,187387408,256059356,0.731812
17930,1,17930,187405338,256059356,0.731882
17933,1,17933,187423271,256059356,0.731952
17939,1,17939,187441210,256059356,0.732023
17950,1,17950,187459160,256059356,0.732093
17970,1,17970,187477130,256059356,0.732163
18147,1,18147,187495277,256059356,0.732234
18188,1,18188,187513465,256059356,0.732305
18302,1,18302,187531767,256059356,0.732376
18446,1,18446,187550213,256059356,0.732448
18453,2,36906,187587119,256059356,0.732592
18458,2,36916,187624035,256059356,0.732736
18507,1,18507,187642542,256059356,0.732809
18513,1,18513,187661055,256059356,0.732881
18550,1,18550,187679605,256059356,0.732954
18571,1,18571,187698176,256059356,0.733026
18610,1,18610,187716786,256059356,0.733099
18635,1,18635,187735421,256059356,0.733171
18641,1,18641,187754062,256059356,0.733244
18662,1,18662,187772724,256059356,0.733317
18689,1,18689,187791413,256059356,0.73339
18703,1,18703,187810116,256059356,0.733463
18739,1,18739,187828855,256059356,0.733536
18767,1,18767,187847622,256059356,0.73361
18784,1,18784,187866406,256059356,0.733683
18786,1,18786,187885192,256059356,0.733756
18915,1,18915,187904107,256059356,0.73383
18953,1,18953,187923060,256059356,0.733904
18965,1,18965,187942025,256059356,0.733978
18991,1,18991,187961016,256059356,0.734053
19010,1,19010,187980026,256059356,0.734127
19014,1,19014,187999040,256059356,0.734201
19025,1,19025,188018065,256059356,0.734275
19066,1,19066,188037131,256059356,0.73435
19105,1,19105,188056236,256059356,0.734424
19206,1,19206,188075442,256059356,0.734499
19219,1,19219,188094661,256059356,0.734574
19234,1,19234,188113895,256059356,0.73465
19311,1,19311,188133206,256059356,0.734725
19369,1,19369,188152575,256059356,0.734801
19406,1,19406,188171981,256059356,0.734876
19564,1,19564,188191545,256059356,0.734953
19638,1,19638,188211183,256059356,0.73503
19671,1,19671,188230854,256059356,0.735106
19674,1,19674,188250528,256059356,0.735183
19675,1,19675,188270203,256059356,0.73526
19701,1,19701,188289904,256059356,0.735337
19732,1,19732,188309636,256059356,0.735414
19736,1,19736,188329372,256059356,0.735491
19756,1,19756,188349128,256059356,0.735568
19813,1,19813,188368941,256059356,0.735646
19851,1,19851,188388792,256059356,0.735723
19854,1,19854,188408646,256059356,0.735801
19868,1,19868,188428514,256059356,0.735878
19932,1,19932,188448446,256059356,0.735956
19944,1,19944,188468390,256059356,0.736034
19979,1,19979,188488369,256059356,0.736112
19981,1,19981,188508350,256059356,0.73619
19993,1,19993,188528343,256059356,0.736268
20010,1,20010,188548353,256059356,0.736346
20026,1,20026,188568379,256059356,0.736424
20047,1,20047,188588426,256059356,0.736503
20057,1,20057,188608483,256059356,0.736581
20059,1,20059,188628542,256059356,0.736659
20101,1,20101,188648643,256059356,0.736738
20160,1,20160,188668803,256059356,0.736817
20210,1,20210,188689013,256059356,0.736896
20237,1,20237,188709250,256059356,0.736975
20246,1,20246,188729496,256059356,0.737054
20248,1,20248,188749744,256059356,0.737133
20250,1,20250,188769994,256059356,0.737212
20262,1,20262,188790256,256059356,0.737291
20287,1,20287,188810543,256059356,0.73737
20320,1,20320,188830863,256059356,0.73745
20326,1,20326,188851189,256059356,0.737529
20419,1,20419,188871608,256059356,0.737609
20558,1,20558,188892166,256059356,0.737689
20573,1,20573,188912739,256059356,0.737769
20712,1,20712,188933451,256059356,0.73785
20742,1,20742,188954193,256059356,0.737931
20746,1,20746,188974939,256059356,0.738012
20747,1,20747,188995686,256059356,0.738093
20764,1,20764,189016450,256059356,0.738174
20790,1,20790,189037240,256059356,0.738256
20810,1,20810,189058050,256059356,0.738337
20852,1,20852,189078902,256059356,0.738418
20856,1,20856,189099758,256059356,0.7385
21001,1,21001,189120759,256059356,0.738582
21154,1,21154,189141913,256059356,0.738664
21162,1,21162,189163075,256059356,0.738747
21184,1,21184,189184259,256059356,0.73883
21316,1,21316,189205575,256059356,0.738913
21318,1,21318,189226893,256059356,0.738996
21319,1,21319,189248212,256059356,0.739079
21323,1,21323,189269535,256059356,0.739163
21334,1,21334,189290869,256059356,0.739246
21349,1,21349,189312218,256059356,0.739329
21419,1,21419,189333637,256059356,0.739413
21454,1,21454,189355091,256059356,0.739497
21456,1,21456,189376547,256059356,0.739581
21528,1,21528,189398075,256059356,0.739665
21534,1,21534,189419609,256059356,0.739749
21586,1,21586,189441195,256059356,0.739833
21599,1,21599,189462794,256059356,0.739917
21672,1,21672,189484466,256059356,0.740002
21679,1,21679,189506145,256059356,0.740087
21692,1,21692,189527837,256059356,0.740171
21766,1,21766,189549603,256059356,0.740257
21817,1,21817,189571420,256059356,0.740342
21835,1,21835,189593255,256059356,0.740427
21840,1,21840,189615095,256059356,0.740512
21863,1,21863,189636958,256059356,0.740598
21924,1,21924,189658882,256059356,0.740683
21929,1,21929,189680811,256059356,0.740769
21933,1,21933,189702744,256059356,0.740855
22109,1,22109,189724853,256059356,0.740941
22124,1,22124,189746977,256059356,0.741027
22191,1,22191,189769168,256059356,0.741114
22220,1,22220,189791388,256059356,0.741201
22236,2,44472,189835860,256059356,0.741374
22268,1,22268,189858128,256059356,0.741461
22401,1,22401,189880529,256059356,0.741549
22491,1,22491,189903020,256059356,0.741637
22524,1,22524,189925544,256059356,0.741725
22608,2,45216,189970760,256059356,0.741901
22611,1,22611,189993371,256059356,0.74199
22697,1,22697,190016068,256059356,0.742078
22757,1,22757,190038825,256059356,0.742167
22793,1,22793,190061618,256059356,0.742256
22915,1,22915,190084533,256059356,0.742346
22945,1,22945,190107478,256059356,0.742435
22957,1,22957,190130435,256059356,0.742525
23015,1,23015,190153450,256059356,0.742615
23024,1,23024,190176474,256059356,0.742705
23153,1,23153,190199627,256059356,0.742795
23349,1,23349,190222976,256059356,0.742886
23432,1,23432,190246408,256059356,0.742978
23478,1,23478,190269886,256059356,0.743069
23514,1,23514,190293400,256059356,0.743161
23515,1,23515,190316915,256059356,0.743253
23554,1,23554,190340469,256059356,0.743345
23632,1,23632,190364101,256059356,0.743437
23639,1,23639,190387740,256059356,0.74353
23810,1,23810,190411550,256059356,0.743623
23872,1,23872,190435422,256059356,0.743716
23879,1,23879,190459301,256059356,0.743809
23927,1,23927,190483228,256059356,0.743903
24010,1,24010,190507238,256059356,0.743996
24014,1,24014,190531252,256059356,0.74409
24041,1,24041,190555293,256059356,0.744184
24074,1,24074,190579367,256059356,0.744278
24106,1,24106,190603473,256059356,0.744372
24215,1,24215,190627688,256059356,0.744467
24224,1,24224,190651912,256059356,0.744561
24280,1,24280,190676192,256059356,0.744656
24290,1,24290,190700482,256059356,0.744751
24380,1,24380,190724862,256059356,0.744846
24473,1,24473,190749335,256059356,0.744942
24544,1,24544,190773879,256059356,0.745038
24671,1,24671,190798550,256059356,0.745134
24831,1,24831,190823381,256059356,0.745231
24851,1,24851,190848232,256059356,0.745328
24977,1,24977,190873209,256059356,0.745426
25014,1,25014,190898223,256059356,0.745523
25018,1,25018,190923241,256059356,0.745621
25084,1,25084,190948325,256059356,0.745719
25103,1,25103,190973428,256059356,0.745817
25114,1,25114,190998542,256059356,0.745915
25115,1,25115,191023657,256059356,0.746013
25124,1,25124,191048781,256059356,0.746111
25192,1,25192,191073973,256059356,0.74621
25195,1,25195,191099168,256059356,0.746308
25200,2,50400,191149568,256059356,0.746505
25232,1,25232,191174800,256059356,0.746603
25515,1,25515,191200315,256059356,0.746703
25526,1,25526,191225841,256059356,0.746803
25533,1,25533,191251374,256059356,0.746903
25626,1,25626,191277000,256059356,0.747003
25640,1,25640,191302640,256059356,0.747103
25664,1,25664,191328304,256059356,0.747203
25853,1,25853,191354157,256059356,0.747304
25893,1,25893,191380050,256059356,0.747405
26061,1,26061,191406111,256059356,0.747507
26086,1,26086,191432197,256059356,0.747609
26163,1,26163,191458360,256059356,0.747711
26166,1,26166,191484526,256059356,0.747813
26220,1,26220,191510746,256059356,0.747915
26266,1,26266,191537012,256059356,0.748018
26279,1,26279,191563291,256059356,0.748121
26295,1,26295,191589586,256059356,0.748223
26329,1,26329,191615915,256059356,0.748326
26351,1,26351,191642266,256059356,0.748429
26422,1,26422,191668688,256059356,0.748532
26435,1,26435,191695123,256059356,0.748635
26490,1,26490,191721613,256059356,0.748739
26550,1,26550,191748163,256059356,0.748843
26654,1,26654,191774817,256059356,0.748947
26691,1,26691,191801508,256059356,0.749051
26717,1,26717,191828225,256059356,0.749155
26718,1,26718,191854943,256059356,0.74926
26828,1,26828,191881771,256059356,0.749364
26898,1,26898,191908669,256059356,0.749469
26952,1,26952,191935621,256059356,0.749575
27107,1,27107,191962728,256059356,0.749681
27169,1,27169,191989897,256059356,0.749787
27174,1,27174,192017071,256059356,0.749893
27526,1,27526,192044597,256059356,0.75
27661,1,27661,192072258,256059356,0.750108
27740,1,27740,192099998,256059356,0.750217
27859,1,27859,192127857,256059356,0.750325
27902,1,27902,192155759,256059356,0.750434
27914,1,27914,192183673,256059356,0.750543
28289,1,28289,192211962,256059356,0.750654
28328,1,28328,192240290,256059356,0.750765
28414,1,28414,192268704,256059356,0.750876
28465,1,28465,192297169,256059356,0.750987
28651,1,28651,192325820,256059356,0.751099
28754,1,28754,192354574,256059356,0.751211
28757,1,28757,192383331,256059356,0.751323
28763,1,28763,192412094,256059356,0.751436
28842,1,28842,192440936,256059356,0.751548
28877,1,28877,192469813,256059356,0.751661
28892,1,28892,192498705,256059356,0.751774
28893,1,28893,192527598,256059356,0.751887
28974,1,28974,192556572,256059356,0.752
29071,1,29071,192585643,256059356,0.752113
29139,1,29139,192614782,256059356,0.752227
29169,1,29169,192643951,256059356,0.752341
29354,1,29354,192673305,256059356,0.752456
29533,1,29533,192702838,256059356,0.752571
29576,1,29576,192732414,256059356,0.752686
29618,1,29618,192762032,256059356,0.752802
29645,1,29645,192791677,256059356,0.752918
29723,1,29723,192821400,256059356,0.753034
29759,1,29759,192851159,256059356,0.75315
29769,1,29769,192880928,256059356,0.753266
29994,1,29994,192910922,256059356,0.753384
30166,1,30166,192941088,256059356,0.753501
30345,1,30345,192971433,256059356,0.75362
30414,1,30414,193001847,256059356,0.753739
30422,1,30422,193032269,256059356,0.753858
30428,1,30428,193062697,256059356,0.753976
30458,1,30458,193093155,256059356,0.754095
30750,1,30750,193123905,256059356,0.754215
30835,1,30835,193154740,256059356,0.754336
30997,1,30997,193185737,256059356,0.754457
31073,1,31073,193216810,256059356,0.754578
31187,1,31187,193247997,256059356,0.7547
31200,1,31200,193279197,256059356,0.754822
31270,1,31270,193310467,256059356,0.754944
31283,1,31283,193341750,256059356,0.755066
31294,1,31294,193373044,256059356,0.755188
31350,1,31350,193404394,256059356,0.755311
31479,1,31479,193435873,256059356,0.755434
31535,1,31535,193467408,256059356,0.755557
31541,1,31541,193498949,256059356,0.75568
31566,1,31566,193530515,256059356,0.755803
31932,1,31932,193562447,256059356,0.755928
31953,1,31953,193594400,256059356,0.756053
31975,1,31975,193626375,256059356,0.756178
31999,1,31999,193658374,256059356,0.756303
32033,1,32033,193690407,256059356,0.756428
32223,1,32223,193722630,256059356,0.756554
32490,1,32490,193755120,256059356,0.75668
32540,1,32540,193787660,256059356,0.756808
32614,1,32614,193820274,256059356,0.756935
32715,1,32715,193852989,256059356,0.757063
32762,1,32762,193885751,256059356,0.757191
32958,1,32958,193918709,256059356,0.757319
33384,1,33384,193952093,256059356,0.75745
33556,1,33556,193985649,256059356,0.757581
33557,1,33557,194019206,256059356,0.757712
33567,1,33567,194052773,256059356,0.757843
33771,1,33771,194086544,256059356,0.757975
34118,1,34118,194120662,256059356,0.758108
34150,1,34150,194154812,256059356,0.758241
34198,1,34198,194189010,256059356,0.758375
34402,1,34402,194223412,256059356,0.758509
34444,1,34444,194257856,256059356,0.758644
34459,1,34459,194292315,256059356,0.758778
34466,1,34466,194326781,256059356,0.758913
34676,1,34676,194361457,256059356,0.759048
34851,1,34851,194396308,256059356,0.759185
34903,1,34903,194431211,256059356,0.759321
35563,1,35563,194466774,256059356,0.75946
35666,1,35666,194502440,256059356,0.759599
35785,1,35785,194538225,256059356,0.759739
35848,1,35848,194574073,256059356,0.759879
35860,1,35860,194609933,256059356,0.760019
35922,1,35922,194645855,256059356,0.760159
36016,1,36016,194681871,256059356,0.7603
36021,1,36021,194717892,256059356,0.76044
36127,1,36127,194754019,256059356,0.760582
36263,1,36263,194790282,256059356,0.760723
36284,1,36284,194826566,256059356,0.760865
36441,1,36441,194863007,256059356,0.761007
36633,1,36633,194899640,256059356,0.76115
36669,1,36669,194936309,256059356,0.761293
36670,1,36670,194972979,256059356,0.761437
36706,1,36706,195009685,256059356,0.76158
36843,1,36843,195046528,256059356,0.761724
36938,1,36938,195083466,256059356,0.761868
37163,1,37163,195120629,256059356,0.762013
37324,1,37324,195157953,256059356,0.762159
37349,1,37349,195195302,256059356,0.762305
37541,1,37541,195232843,256059356,0.762452
37782,1,37782,195270625,256059356,0.762599
37843,1,37843,195308468,256059356,0.762747
38076,1,38076,195346544,256059356,0.762896
38184,1,38184,195384728,256059356,0.763045
38216,1,38216,195422944,256059356,0.763194
38384,1,38384,195461328,256059356,0.763344
38515,1,38515,195499843,256059356,0.763494
38673,1,38673,195538516,256059356,0.763645
39007,1,39007,195577523,256059356,0.763798
39068,1,39068,195616591,256059356,0.76395
39204,1,39204,195655795,256059356,0.764103
39278,1,39278,195695073,256059356,0.764257
39406,1,39406,195734479,256059356,0.764411
39476,1,39476,195773955,256059356,0.764565
39639,1,39639,195813594,256059356,0.76472
39644,1,39644,195853238,256059356,0.764874
39742,1,39742,195892980,256059356,0.76503
39827,1,39827,195932807,256059356,0.765185
39836,1,39836,195972643,256059356,0.765341
39867,1,39867,196012510,256059356,0.765496
39989,1,39989,196052499,256059356,0.765653
40057,1,40057,196092556,256059356,0.765809
40108,1,40108,196132664,256059356,0.765966
40272,1,40272,196172936,256059356,0.766123
40425,1,40425,196213361,256059356,0.766281
40559,1,40559,196253920,256059356,0.766439
40646,1,40646,196294566,256059356,0.766598
40945,1,40945,196335511,256059356,0.766758
41036,1,41036,196376547,256059356,0.766918
41159,1,41159,196417706,256059356,0.767079
41429,1,41429,196459135,256059356,0.767241
41704,1,41704,196500839,256059356,0.767403
41737,1,41737,196542576,256059356,0.767566
42026,1,42026,196584602,256059356,0.767731
42128,1,42128,196626730,256059356,0.767895
42193,1,42193,196668923,256059356,0.76806
42415,1,42415,196711338,256059356,0.768226
42427,1,42427,196753765,256059356,0.768391
42453,1,42453,196796218,256059356,0.768557
43026,1,43026,196839244,256059356,0.768725
43194,1,43194,196882438,256059356,0.768894
43292,1,43292,196925730,256059356,0.769063
43359,1,43359,196969089,256059356,0.769232
43539,1,43539,197012628,256059356,0.769402
43996,1,43996,197056624,256059356,0.769574
44243,1,44243,197100867,256059356,0.769747
44605,1,44605,197145472,256059356,0.769921
44755,1,44755,197190227,256059356,0.770096
44929,1,44929,197235156,256059356,0.770271
44954,1,44954,197280110,256059356,0.770447
45390,1,45390,197325500,256059356,0.770624
45580,1,45580,197371080,256059356,0.770802
45621,1,45621,197416701,256059356,0.77098
45711,1,45711,197462412,256059356,0.771159
45970,1,45970,197508382,256059356,0.771338
46007,1,46007,197554389,256059356,0.771518
46063,1,46063,197600452,256059356,0.771698
46277,1,46277,197646729,256059356,0.771879
46586,1,46586,197693315,256059356,0.772061
46594,1,46594,197739909,256059356,0.772242
46671,1,46671,197786580,256059356,0.772425
46998,1,46998,197833578,256059356,0.772608
47325,1,47325,197880903,256059356,0.772793
47649,1,47649,197928552,256059356,0.772979
47685,2,95370,198023922,256059356,0.773352
47798,1,47798,198071720,256059356,0.773538
47863,1,47863,198119583,256059356,0.773725
47918,1,47918,198167501,256059356,0.773912
48236,1,48236,198215737,256059356,0.774101
48360,1,48360,198264097,256059356,0.77429
48398,1,48398,198312495,256059356,0.774479
48485,1,48485,198360980,256059356,0.774668
48534,1,48534,198409514,256059356,0.774858
48662,1,48662,198458176,256059356,0.775048
48679,1,48679,198506855,256059356,0.775238
48771,1,48771,198555626,256059356,0.775428
48914,1,48914,198604540,256059356,0.775619
49052,1,49052,198653592,256059356,0.775811
49165,1,49165,198702757,256059356,0.776003
49175,1,49175,198751932,256059356,0.776195
49262,1,49262,198801194,256059356,0.776387
49327,1,49327,198850521,256059356,0.77658
49386,1,49386,198899907,256059356,0.776773
49393,1,49393,198949300,256059356,0.776966
49415,1,49415,198998715,256059356,0.777159
49830,1,49830,199048545,256059356,0.777353
49842,1,49842,199098387,256059356,0.777548
49878,1,49878,199148265,256059356,0.777743
50209,1,50209,199198474,256059356,0.777939
50282,1,50282,199248756,256059356,0.778135
50380,1,50380,199299136,256059356,0.778332
51048,1,51048,199350184,256059356,0.778531
51619,1,51619,199401803,256059356,0.778733
51766,1,51766,199453569,256059356,0.778935
51919,1,51919,199505488,256059356,0.779138
51981,1,51981,199557469,256059356,0.779341
52030,1,52030,199609499,256059356,0.779544
52235,1,52235,199661734,256059356,0.779748
52368,1,52368,199714102,256059356,0.779952
52604,1,52604,199766706,256059356,0.780158
52671,1,52671,199819377,256059356,0.780364
52713,1,52713,199872090,256059356,0.780569
52965,1,52965,199925055,256059356,0.780776
52998,1,52998,199978053,256059356,0.780983
53124,1,53124,200031177,256059356,0.781191
53150,1,53150,200084327,256059356,0.781398
53205,1,53205,200137532,256059356,0.781606
53290,1,53290,200190822,256059356,0.781814
53367,1,53367,200244189,256059356,0.782023
53680,1,53680,200297869,256059356,0.782232
53830,1,53830,200351699,256059356,0.782442
53840,1,53840,200405539,256059356,0.782653
53991,2,107982,200513521,256059356,0.783074
54054,1,54054,200567575,256059356,0.783285
54330,1,54330,200621905,256059356,0.783498
54336,1,54336,200676241,256059356,0.78371
54839,1,54839,200731080,256059356,0.783924
55869,1,55869,200786949,256059356,0.784142
56049,1,56049,200842998,256059356,0.784361
56149,1,56149,200899147,256059356,0.78458
56329,1,56329,200955476,256059356,0.7848
56706,1,56706,201012182,256059356,0.785022
56716,1,56716,201068898,256059356,0.785243
56886,1,56886,201125784,256059356,0.785465
57097,1,57097,201182881,256059356,0.785688
57316,1,57316,201240197,256059356,0.785912
57543,1,57543,201297740,256059356,0.786137
57574,1,57574,201355314,256059356,0.786362
57575,1,57575,201412889,256059356,0.786587
57596,1,57596,201470485,256059356,0.786812
58280,1,58280,201528765,256059356,0.787039
58585,1,58585,201587350,256059356,0.787268
58829,1,58829,201646179,256059356,0.787498
59007,1,59007,201705186,256059356,0.787728
60950,1,60950,201766136,256059356,0.787966
61478,1,61478,201827614,256059356,0.788206
62430,1,62430,201890044,256059356,0.78845
62820,1,62820,201952864,256059356,0.788696
62946,1,62946,202015810,256059356,0.788941
63552,1,63552,202079362,256059356,0.78919
63726,1,63726,202143088,256059356,0.789438
63783,1,63783,202206871,256059356,0.789687
64113,1,64113,202270984,256059356,0.789938
64427,1,64427,202335411,256059356,0.790189
64700,1,64700,202400111,256059356,0.790442
65003,1,65003,202465114,256059356,0.790696
65141,1,65141,202530255,256059356,0.79095
65285,1,65285,202595540,256059356,0.791205
65432,1,65432,202660972,256059356,0.791461
65579,1,65579,202726551,256059356,0.791717
65594,1,65594,202792145,256059356,0.791973
65794,1,65794,202857939,256059356,0.79223
66083,1,66083,202924022,256059356,0.792488
66387,1,66387,202990409,256059356,0.792747
66761,1,66761,203057170,256059356,0.793008
66840,1,66840,203124010,256059356,0.793269
67061,1,67061,203191071,256059356,0.793531
67631,1,67631,203258702,256059356,0.793795
67797,1,67797,203326499,256059356,0.79406
68261,1,68261,203394760,256059356,0.794327
69175,1,69175,203463935,256059356,0.794597
69242,1,69242,203533177,256059356,0.794867
69638,1,69638,203602815,256059356,0.795139
70155,1,70155,203672970,256059356,0.795413
70442,1,70442,203743412,256059356,0.795688
70511,1,70511,203813923,256059356,0.795964
70651,1,70651,203884574,256059356,0.79624
70999,1,70999,203955573,256059356,0.796517
71779,1,71779,204027352,256059356,0.796797
72063,1,72063,204099415,256059356,0.797079
72462,1,72462,204171877,256059356,0.797362
72504,1,72504,204244381,256059356,0.797645
73170,1,73170,204317551,256059356,0.79793
73331,1,73331,204390882,256059356,0.798217
73352,1,73352,204464234,256059356,0.798503
73364,1,73364,204537598,256059356,0.79879
73370,1,73370,204610968,256059356,0.799076
73373,1,73373,204684341,256059356,0.799363
73451,2,146902,204831243,256059356,0.799937
73452,2,146904,204978147,256059356,0.80051
74865,1,74865,205053012,256059356,0.800803
75111,1,75111,205128123,256059356,0.801096
75126,1,75126,205203249,256059356,0.801389
75191,1,75191,205278440,256059356,0.801683
75357,1,75357,205353797,256059356,0.801977
75477,1,75477,205429274,256059356,0.802272
75626,1,75626,205504900,256059356,0.802567
75656,1,75656,205580556,256059356,0.802863
76504,1,76504,205657060,256059356,0.803162
76657,1,76657,205733717,256059356,0.803461
76862,1,76862,205810579,256059356,0.803761
77426,1,77426,205888005,256059356,0.804064
78985,1,78985,205966990,256059356,0.804372
79364,1,79364,206046354,256059356,0.804682
79974,1,79974,206126328,256059356,0.804994
80193,1,80193,206206521,256059356,0.805308
80552,1,80552,206287073,256059356,0.805622
80590,1,80590,206367663,256059356,0.805937
80840,1,80840,206448503,256059356,0.806253
81128,1,81128,206529631,256059356,0.806569
81398,1,81398,206611029,256059356,0.806887
81586,1,81586,206692615,256059356,0.807206
82173,1,82173,206774788,256059356,0.807527
82307,1,82307,206857095,256059356,0.807848
82420,1,82420,206939515,256059356,0.80817
82429,1,82429,207021944,256059356,0.808492
82633,1,82633,207104577,256059356,0.808815
82699,1,82699,207187276,256059356,0.809138
83781,1,83781,207271057,256059356,0.809465
84145,1,84145,207355202,256059356,0.809793
84174,1,84174,207439376,256059356,0.810122
84903,1,84903,207524279,256059356,0.810454
85010,1,85010,207609289,256059356,0.810786
85323,1,85323,207694612,256059356,0.811119
85512,1,85512,207780124,256059356,0.811453
85552,1,85552,207865676,256059356,0.811787
85981,1,85981,207951657,256059356,0.812123
86793,1,86793,208038450,256059356,0.812462
86801,1,86801,208125251,256059356,0.812801
87070,1,87070,208212321,256059356,0.813141
87569,1,87569,208299890,256059356,0.813483
88109,1,88109,208387999,256059356,0.813827
88200,1,88200,208476199,256059356,0.814171
88455,1,88455,208564654,256059356,0.814517
88576,1,88576,208653230,256059356,0.814863
88785,1,88785,208742015,256059356,0.815209
89182,1,89182,208831197,256059356,0.815558
89231,1,89231,208920428,256059356,0.815906
89247,1,89247,209009675,256059356,0.816255
89271,1,89271,209098946,256059356,0.816603
89379,1,89379,209188325,256059356,0.816952
89941,1,89941,209278266,256059356,0.817304
89969,1,89969,209368235,256059356,0.817655
90152,1,90152,209458387,256059356,0.818007
90377,1,90377,209548764,256059356,0.81836
90396,1,90396,209639160,256059356,0.818713
90452,2,180904,209820064,256059356,0.81942
90456,1,90456,209910520,256059356,0.819773
90471,1,90471,210000991,256059356,0.820126
90493,1,90493,210091484,256059356,0.82048
90624,1,90624,210182108,256059356,0.820834
90645,1,90645,210272753,256059356,0.821188
90647,1,90647,210363400,256059356,0.821542
90652,1,90652,210454052,256059356,0.821896
90653,1,90653,210544705,256059356,0.82225
90658,1,90658,210635363,256059356,0.822604
90659,1,90659,210726022,256059356,0.822958
90667,1,90667,210816689,256059356,0.823312
90772,1,90772,210907461,256059356,0.823666
90873,1,90873,210998334,256059356,0.824021
91070,1,91070,211089404,256059356,0.824377
91280,1,91280,211180684,256059356,0.824733
91460,1,91460,211272144,256059356,0.825091
91583,1,91583,211363727,256059356,0.825448
91789,1,91789,211455516,256059356,0.825807
91841,1,91841,211547357,256059356,0.826165
91843,1,91843,211639200,256059356,0.826524
91939,1,91939,211731139,256059356,0.826883
92549,1,92549,211823688,256059356,0.827244
92735,1,92735,211916423,256059356,0.827607
92741,1,92741,212009164,256059356,0.827969
92835,1,92835,212101999,256059356,0.828331
92923,1,92923,212194922,256059356,0.828694
93045,1,93045,212287967,256059356,0.829058
93322,1,93322,212381289,256059356,0.829422
93433,1,93433,212474722,256059356,0.829787
93523,1,93523,212568245,256059356,0.830152
93650,1,93650,212661895,256059356,0.830518
93712,1,93712,212755607,256059356,0.830884
93725,1,93725,212849332,256059356,0.83125
93743,1,93743,212943075,256059356,0.831616
93920,1,93920,213036995,256059356,0.831983
93957,1,93957,213130952,256059356,0.83235
94651,3,283953,213414905,256059356,0.833459
94655,1,94655,213509560,256059356,0.833828
94833,1,94833,213604393,256059356,0.834199
94958,1,94958,213699351,256059356,0.83457
95417,1,95417,213794768,256059356,0.834942
95994,1,95994,213890762,256059356,0.835317
96008,1,96008,213986770,256059356,0.835692
96423,1,96423,214083193,256059356,0.836069
97281,1,97281,214180474,256059356,0.836449
97855,1,97855,214278329,256059356,0.836831
97857,1,97857,214376186,256059356,0.837213
97874,1,97874,214474060,256059356,0.837595
98029,1,98029,214572089,256059356,0.837978
98377,1,98377,214670466,256059356,0.838362
102203,1,102203,214772669,256059356,0.838761
102674,1,102674,214875343,256059356,0.839162
104876,1,104876,214980219,256059356,0.839572
105107,1,105107,215085326,256059356,0.839982
105978,1,105978,215191304,256059356,0.840396
107156,1,107156,215298460,256059356,0.840815
107169,1,107169,215405629,256059356,0.841233
107170,1,107170,215512799,256059356,0.841652
107935,1,107935,215620734,256059356,0.842073
108113,1,108113,215728847,256059356,0.842495
108137,1,108137,215836984,256059356,0.842918
108575,1,108575,215945559,256059356,0.843342
109250,1,109250,216054809,256059356,0.843768
109515,1,109515,216164324,256059356,0.844196
109517,1,109517,216273841,256059356,0.844624
109610,1,109610,216383451,256059356,0.845052
109871,1,109871,216493322,256059356,0.845481
109893,1,109893,216603215,256059356,0.84591
111349,1,111349,216714564,256059356,0.846345
112684,1,112684,216827248,256059356,0.846785
113286,1,113286,216940534,256059356,0.847228
113423,1,113423,217053957,256059356,0.84767
114947,1,114947,217168904,256059356,0.848119
115618,1,115618,217284522,256059356,0.848571
115626,1,115626,217400148,256059356,0.849022
118512,1,118512,217518660,256059356,0.849485
118883,1,118883,217637543,256059356,0.84995
119732,1,119732,217757275,256059356,0.850417
121510,1,121510,217878785,256059356,0.850892
124587,1,124587,218003372,256059356,0.851378
126912,2,253824,218257196,256059356,0.85237
126916,1,126916,218384112,256059356,0.852865
126917,1,126917,218511029,256059356,0.853361
127039,1,127039,218638068,256059356,0.853857
130457,2,260914,218898982,256059356,0.854876
130458,2,260916,219159898,256059356,0.855895
130459,1,130459,219290357,256059356,0.856404
130460,1,130460,219420817,256059356,0.856914
130463,1,130463,219551280,256059356,0.857423
130666,1,130666,219681946,256059356,0.857934
131993,1,131993,219813939,256059356,0.858449
132036,1,132036,219945975,256059356,0.858965
134603,1,134603,220080578,256059356,0.85949
138652,1,138652,220219230,256059356,0.860032
139029,1,139029,220358259,256059356,0.860575
141227,1,141227,220499486,256059356,0.861126
141411,1,141411,220640897,256059356,0.861679
146644,1,146644,220787541,256059356,0.862251
158977,1,158977,220946518,256059356,0.862872
159841,1,159841,221106359,256059356,0.863497
162271,1,162271,221268630,256059356,0.86413
164968,1,164968,221433598,256059356,0.864774
168585,1,168585,221602183,256059356,0.865433
168605,1,168605,221770788,256059356,0.866091
173267,1,173267,221944055,256059356,0.866768
180813,1,180813,222124868,256059356,0.867474
183173,1,183173,222308041,256059356,0.868189
185345,1,185345,222493386,256059356,0.868913
190102,1,190102,222683488,256059356,0.869656
190442,1,190442,222873930,256059356,0.870399
211899,1,211899,223085829,256059356,0.871227
215150,1,215150,223300979,256059356,0.872067
233094,1,233094,223534073,256059356,0.872978
239906,1,239906,223773979,256059356,0.873914
246589,1,246589,224020568,256059356,0.874877
247102,1,247102,224267670,256059356,0.875843
247140,1,247140,224514810,256059356,0.876808
253824,1,253824,224768634,256059356,0.877799
255090,1,255090,225023724,256059356,0.878795
255520,1,255520,225279244,256059356,0.879793
260919,1,260919,225540163,256059356,0.880812
260921,1,260921,225801084,256059356,0.881831
322482,1,322482,226123566,256059356,0.88309
347649,1,347649,226471215,256059356,0.884448
369812,1,369812,226841027,256059356,0.885892
406486,1,406486,227247513,256059356,0.88748
496203,1,496203,227743716,256059356,0.889418
582518,1,582518,228326234,256059356,0.891693
3599322,1,3599322,231925556,256059356,0.905749
3632541,1,3632541,235558097,256059356,0.919936
3687352,1,3687352,239245449,256059356,0.934336
3812296,1,3812296,243057745,256059356,0.949224
3867887,1,3867887,246925632,256059356,0.96433
4414735,1,4414735,251340367,256059356,0.981571
4718989,1,4718989,256059356,256059356,1
