1,92957461,92957461,92957461,256059356,0.363031
2,8092534,16185068,109142529,256059356,0.426239
3,1378247,4134741,113277270,256059356,0.442387
4,520425,2081700,115358970,256059356,0.450517
5,256994,1284970,116643940,256059356,0.455535
6,175870,1055220,117699160,256059356,0.459656
7,126136,882952,118582112,256059356,0.463104
8,86333,690664,119272776,256059356,0.465801
9,63318,569862,119842638,256059356,0.468027
10,53567,535670,120378308,256059356,0.470119
11,41439,455829,120834137,256059356,0.471899
12,37585,451020,121285157,256059356,0.47366
13,30707,399191,121684348,256059356,0.475219
14,27760,388640,122072988,256059356,0.476737
15,23693,355395,122428383,256059356,0.478125
16,21779,348464,122776847,256059356,0.479486
17,18812,319804,123096651,256059356,0.480735
18,17808,320544,123417195,256059356,0.481987
19,15823,300637,123717832,256059356,0.483161
20,15388,307760,124025592,256059356,0.484363
21,13765,289065,124314657,256059356,0.485492
22,12550,276100,124590757,256059356,0.48657
23,11804,271492,124862249,256059356,0.48763
24,10781,258744,125120993,256059356,0.488641
25,10033,250825,125371818,256059356,0.48962
26,9636,250536,125622354,256059356,0.490599
27,9625,259875,125882229,256059356,0.491613
28,9657,270396,126152625,256059356,0.492669
29,9266,268714,126421339,256059356,0.493719
30,9879,296370,126717709,256059356,0.494876
31,9643,298933,127016642,256059356,0.496044
32,8816,282112,127298754,256059356,0.497145
33,8301,273933,127572687,256059356,0.498215
34,7823,265982,127838669,256059356,0.499254
35,7111,248885,128087554,256059356,0.500226
36,7271,261756,128349310,256059356,0.501248
37,6908,255596,128604906,256059356,0.502246
38,6675,253650,128858556,256059356,0.503237
39,6132,239148,129097704,256059356,0.504171
40,6127,245080,129342784,256059356,0.505128
41,5782,237062,129579846,256059356,0.506054
42,5503,231126,129810972,256059356,0.506957
43,4721,203003,130013975,256059356,0.507749
44,4419,194436,130208411,256059356,0.508509
45,4022,180990,130389401,256059356,0.509216
46,3704,170384,130559785,256059356,0.509881
47,3428,161116,130720901,256059356,0.51051
48,3259,156432,130877333,256059356,0.511121
49,3171,155379,131032712,256059356,0.511728
50,2982,149100,131181812,256059356,0.51231
51,2762,140862,131322674,256059356,0.51286
52,2634,136968,131459642,256059356,0.513395
53,2664,141192,131600834,256059356,0.513947
54,2559,138186,131739020,256059356,0.514486
55,2309,126995,131866015,256059356,0.514982
56,2325,130200,131996215,256059356,0.515491
57,2276,129732,132125947,256059356,0.515997
58,2296,133168,132259115,256059356,0.516517
59,2132,125788,132384903,256059356,0.517009
60,2094,125640,132510543,256059356,0.517499
61,1952,119072,132629615,256059356,0.517964
62,1912,118544,132748159,256059356,0.518427
63,1927,121401,132869560,256059356,0.518901
64,1791,114624,132984184,256059356,0.519349
65,1685,109525,133093709,256059356,0.519777
66,1789,118074,133211783,256059356,0.520238
67,1603,107401,133319184,256059356,0.520657
68,1541,104788,133423972,256059356,0.521067
69,1614,111366,133535338,256059356,0.521501
70,1993,139510,133674848,256059356,0.522046
71,1460,103660,133778508,256059356,0.522451
72,1443,103896,133882404,256059356,0.522857
73,1382,100886,133983290,256059356,0.523251
74,1315,97310,134080600,256059356,0.523631
75,1235,92625,134173225,256059356,0.523993
76,1255,95380,134268605,256059356,0.524365
77,1271,97867,134366472,256059356,0.524747
78,1177,91806,134458278,256059356,0.525106
79,1076,85004,134543282,256059356,0.525438
80,1131,90480,134633762,256059356,0.525791
81,1085,87885,134721647,256059356,0.526134
82,1095,89790,134811437,256059356,0.526485
83,1006,83498,134894935,256059356,0.526811
84,994,83496,134978431,256059356,0.527137
85,995,84575,135063006,256059356,0.527468
86,984,84624,135147630,256059356,0.527798
87,895,77865,135225495,256059356,0.528102
88,861,75768,135301263,256059356,0.528398
89,910,80990,135382253,256059356,0.528714
90,849,76410,135458663,256059356,0.529013
91,843,76713,135535376,256059356,0.529312
92,832,76544,135611920,256059356,0.529611
93,731,67983,135679903,256059356,0.529877
94,831,78114,135758017,256059356,0.530182
95,817,77615,135835632,256059356,0.530485
96,792,76032,135911664,256059356,0.530782
97,724,70228,135981892,256059356,0.531056
98,734,71932,136053824,256059356,0.531337
99,760,75240,136129064,256059356,0.531631
100,733,73300,136202364,256059356,0.531917
101,659,66559,136268923,256059356,0.532177
102,649,66198,136335121,256059356,0.532436
103,647,66641,136401762,256059356,0.532696
104,621,64584,136466346,256059356,0.532948
105,655,68775,136535121,256059356,0.533217
106,587,62222,136597343,256059356,0.53346
107,606,64842,136662185,256059356,0.533713
108,595,64260,136726445,256059356,0.533964
109,565,61585,136788030,256059356,0.534204
110,550,60500,136848530,256059356,0.534441
111,533,59163,136907693,256059356,0.534672
112,535,59920,136967613,256059356,0.534906
113,539,60907,137028520,256059356,0.535144
114,524,59736,137088256,256059356,0.535377
115,539,61985,137150241,256059356,0.535619
116,451,52316,137202557,256059356,0.535823
117,442,51714,137254271,256059356,0.536025
118,490,57820,137312091,256059356,0.536251
119,492,58548,137370639,256059356,0.53648
120,474,56880,137427519,256059356,0.536702
121,447,54087,137481606,256059356,0.536913
122,490,59780,137541386,256059356,0.537146
123,401,49323,137590709,256059356,0.537339
124,454,56296,137647005,256059356,0.537559
125,418,52250,137699255,256059356,0.537763
126,411,51786,137751041,256059356,0.537965
127,384,48768,137799809,256059356,0.538156
128,388,49664,137849473,256059356,0.53835
129,521,67209,137916682,256059356,0.538612
130,377,49010,137965692,256059356,0.538804
131,433,56723,138022415,256059356,0.539025
132,408,53856,138076271,256059356,0.539235
133,400,53200,138129471,256059356,0.539443
134,391,52394,138181865,256059356,0.539648
135,371,50085,138231950,256059356,0.539843
136,434,59024,138290974,256059356,0.540074
137,371,50827,138341801,256059356,0.540272
138,376,51888,138393689,256059356,0.540475
139,380,52820,138446509,256059356,0.540681
140,377,52780,138499289,256059356,0.540887
141,326,45966,138545255,256059356,0.541067
142,374,53108,138598363,256059356,0.541274
143,334,47762,138646125,256059356,0.541461
144,340,48960,138695085,256059356,0.541652
145,344,49880,138744965,256059356,0.541847
146,353,51538,138796503,256059356,0.542048
147,310,45570,138842073,256059356,0.542226
148,343,50764,138892837,256059356,0.542424
149,311,46339,138939176,256059356,0.542605
150,323,48450,138987626,256059356,0.542795
151,310,46810,139034436,256059356,0.542977
152,314,47728,139082164,256059356,0.543164
153,319,48807,139130971,256059356,0.543354
154,301,46354,139177325,256059356,0.543535
155,298,46190,139223515,256059356,0.543716
156,297,46332,139269847,256059356,0.543897
157,285,44745,139314592,256059356,0.544071
158,283,44714,139359306,256059356,0.544246
159,304,48336,139407642,256059356,0.544435
160,255,40800,139448442,256059356,0.544594
161,255,41055,139489497,256059356,0.544755
162,268,43416,139532913,256059356,0.544924
163,286,46618,139579531,256059356,0.545106
164,269,44116,139623647,256059356,0.545278
165,255,42075,139665722,256059356,0.545443
166,289,47974,139713696,256059356,0.54563
167,278,46426,139760122,256059356,0.545811
168,277,46536,139806658,256059356,0.545993
169,251,42419,139849077,256059356,0.546159
170,244,41480,139890557,256059356,0.546321
171,261,44631,139935188,256059356,0.546495
172,261,44892,139980080,256059356,0.54667
173,229,39617,140019697,256059356,0.546825
174,243,42282,140061979,256059356,0.54699
175,228,39900,140101879,256059356,0.547146
176,218,38368,140140247,256059356,0.547296
177,222,39294,140179541,256059356,0.547449
178,184,32752,140212293,256059356,0.547577
179,236,42244,140254537,256059356,0.547742
180,214,38520,140293057,256059356,0.547893
181,279,50499,140343556,256059356,0.54809
182,260,47320,140390876,256059356,0.548275
183,254,46482,140437358,256059356,0.548456
184,270,49680,140487038,256059356,0.54865
185,237,43845,140530883,256059356,0.548822
186,251,46686,140577569,256059356,0.549004
187,259,48433,140626002,256059356,0.549193
188,220,41360,140667362,256059356,0.549355
189,201,37989,140705351,256059356,0.549503
190,212,40280,140745631,256059356,0.54966
191,196,37436,140783067,256059356,0.549806
192,219,42048,140825115,256059356,0.549971
193,225,43425,140868540,256059356,0.55014
194,250,48500,140917040,256059356,0.55033
195,230,44850,140961890,256059356,0.550505
196,211,41356,141003246,256059356,0.550666
197,186,36642,141039888,256059356,0.550809
198,209,41382,141081270,256059356,0.550971
199,209,41591,141122861,256059356,0.551133
200,164,32800,141155661,256059356,0.551261
201,189,37989,141193650,256059356,0.55141
202,210,42420,141236070,256059356,0.551576
203,217,44051,141280121,256059356,0.551748
204,180,36720,141316841,256059356,0.551891
205,172,35260,141352101,256059356,0.552029
206,191,39346,141391447,256059356,0.552182
207,184,38088,141429535,256059356,0.552331
208,182,37856,141467391,256059356,0.552479
209,201,42009,141509400,256059356,0.552643
210,184,38640,141548040,256059356,0.552794
211,164,34604,141582644,256059356,0.552929
212,174,36888,141619532,256059356,0.553073
213,162,34506,141654038,256059356,0.553208
214,183,39162,141693200,256059356,0.553361
215,133,28595,141721795,256059356,0.553472
216,146,31536,141753331,256059356,0.553596
217,131,28427,141781758,256059356,0.553707
218,180,39240,141820998,256059356,0.55386
219,160,35040,141856038,256059356,0.553997
220,168,36960,141892998,256059356,0.554141
221,149,32929,141925927,256059356,0.55427
222,178,39516,141965443,256059356,0.554424
223,161,35903,142001346,256059356,0.554564
224,165,36960,142038306,256059356,0.554709
225,164,36900,142075206,256059356,0.554853
226,175,39550,142114756,256059356,0.555007
227,146,33142,142147898,256059356,0.555137
228,165,37620,142185518,256059356,0.555283
229,144,32976,142218494,256059356,0.555412
230,134,30820,142249314,256059356,0.555533
231,146,33726,142283040,256059356,0.555664
232,151,35032,142318072,256059356,0.555801
233,165,38445,142356517,256059356,0.555951
234,160,37440,142393957,256059356,0.556097
235,128,30080,142424037,256059356,0.556215
236,153,36108,142460145,256059356,0.556356
237,143,33891,142494036,256059356,0.556488
238,125,29750,142523786,256059356,0.556604
239,144,34416,142558202,256059356,0.556739
240,146,35040,142593242,256059356,0.556876
241,152,36632,142629874,256059356,0.557019
242,130,31460,142661334,256059356,0.557142
243,170,41310,142702644,256059356,0.557303
244,150,36600,142739244,256059356,0.557446
245,133,32585,142771829,256059356,0.557573
246,141,34686,142806515,256059356,0.557709
247,126,31122,142837637,256059356,0.55783
248,143,35464,142873101,256059356,0.557969
249,145,36105,142909206,256059356,0.55811
250,150,37500,142946706,256059356,0.558256
251,143,35893,142982599,256059356,0.558396
252,128,32256,143014855,256059356,0.558522
253,109,27577,143042432,256059356,0.55863
254,153,38862,143081294,256059356,0.558782
255,124,31620,143112914,256059356,0.558905
256,127,32512,143145426,256059356,0.559032
257,134,34438,143179864,256059356,0.559167
258,119,30702,143210566,256059356,0.559287
259,123,31857,143242423,256059356,0.559411
260,107,27820,143270243,256059356,0.55952
261,107,27927,143298170,256059356,0.559629
262,114,29868,143328038,256059356,0.559745
263,102,26826,143354864,256059356,0.55985
264,126,33264,143388128,256059356,0.55998
265,115,30475,143418603,256059356,0.560099
266,130,34580,143453183,256059356,0.560234
267,107,28569,143481752,256059356,0.560346
268,102,27336,143509088,256059356,0.560452
269,105,28245,143537333,256059356,0.560563
270,98,26460,143563793,256059356,0.560666
271,123,33333,143597126,256059356,0.560796
272,119,32368,143629494,256059356,0.560923
273,96,26208,143655702,256059356,0.561025
274,118,32332,143688034,256059356,0.561151
275,119,32725,143720759,256059356,0.561279
276,120,33120,143753879,256059356,0.561408
277,95,26315,143780194,256059356,0.561511
278,102,28356,143808550,256059356,0.561622
279,107,29853,143838403,256059356,0.561739
280,119,33320,143871723,256059356,0.561869
281,93,26133,143897856,256059356,0.561971
282,116,32712,143930568,256059356,0.562098
283,94,26602,143957170,256059356,0.562202
284,103,29252,143986422,256059356,0.562317
285,88,25080,144011502,256059356,0.562415
286,93,26598,144038100,256059356,0.562518
287,84,24108,144062208,256059356,0.562613
288,116,33408,144095616,256059356,0.562743
289,101,29189,144124805,256059356,0.562857
290,86,24940,144149745,256059356,0.562954
291,109,31719,144181464,256059356,0.563078
292,106,30952,144212416,256059356,0.563199
293,109,31937,144244353,256059356,0.563324
294,85,24990,144269343,256059356,0.563421
295,76,22420,144291763,256059356,0.563509
296,99,29304,144321067,256059356,0.563623
297,116,34452,144355519,256059356,0.563758
298,97,28906,144384425,256059356,0.563871
299,97,29003,144413428,256059356,0.563984
300,93,27900,144441328,256059356,0.564093
301,82,24682,144466010,256059356,0.56419
302,86,25972,144491982,256059356,0.564291
303,97,29391,144521373,256059356,0.564406
304,81,24624,144545997,256059356,0.564502
305,106,32330,144578327,256059356,0.564628
306,84,25704,144604031,256059356,0.564729
307,83,25481,144629512,256059356,0.564828
308,68,20944,144650456,256059356,0.56491
309,78,24102,144674558,256059356,0.565004
310,71,22010,144696568,256059356,0.56509
311,86,26746,144723314,256059356,0.565194
312,94,29328,144752642,256059356,0.565309
313,87,27231,144779873,256059356,0.565415
314,95,29830,144809703,256059356,0.565532
315,90,28350,144838053,256059356,0.565642
316,87,27492,144865545,256059356,0.56575
317,73,23141,144888686,256059356,0.56584
318,75,23850,144912536,256059356,0.565933
319,80,25520,144938056,256059356,0.566033
320,95,30400,144968456,256059356,0.566152
321,68,21828,144990284,256059356,0.566237
322,78,25116,145015400,256059356,0.566335
323,87,28101,145043501,256059356,0.566445
324,77,24948,145068449,256059356,0.566542
325,87,28275,145096724,256059356,0.566653
326,80,26080,145122804,256059356,0.566755
327,66,21582,145144386,256059356,0.566839
328,67,21976,145166362,256059356,0.566925
329,66,21714,145188076,256059356,0.567009
330,84,27720,145215796,256059356,0.567118
331,71,23501,145239297,256059356,0.567209
332,85,28220,145267517,256059356,0.56732
333,80,26640,145294157,256059356,0.567424
334,94,31396,145325553,256059356,0.567546
335,70,23450,145349003,256059356,0.567638
336,80,26880,145375883,256059356,0.567743
337,62,20894,145396777,256059356,0.567825
338,76,25688,145422465,256059356,0.567925
339,80,27120,145449585,256059356,0.568031
340,61,20740,145470325,256059356,0.568112
341,70,23870,145494195,256059356,0.568205
342,84,28728,145522923,256059356,0.568317
343,74,25382,145548305,256059356,0.568416
344,57,19608,145567913,256059356,0.568493
345,72,24840,145592753,256059356,0.56859
346,68,23528,145616281,256059356,0.568682
347,81,28107,145644388,256059356,0.568792
348,69,24012,145668400,256059356,0.568885
349,79,27571,145695971,256059356,0.568993
350,68,23800,145719771,256059356,0.569086
351,73,25623,145745394,256059356,0.569186
352,83,29216,145774610,256059356,0.5693
353,63,22239,145796849,256059356,0.569387
354,65,23010,145819859,256059356,0.569477
355,62,22010,145841869,256059356,0.569563
356,74,26344,145868213,256059356,0.569666
357,57,20349,145888562,256059356,0.569745
358,67,23986,145912548,256059356,0.569839
359,81,29079,145941627,256059356,0.569952
360,72,25920,145967547,256059356,0.570054
361,62,22382,145989929,256059356,0.570141
362,69,24978,146014907,256059356,0.570239
363,60,21780,146036687,256059356,0.570324
364,73,26572,146063259,256059356,0.570427
365,66,24090,146087349,256059356,0.570521
366,62,22692,146110041,256059356,0.57061
367,71,26057,146136098,256059356,0.570712
368,97,35696,146171794,256059356,0.570851
369,136,50184,146221978,256059356,0.571047
370,72,26640,146248618,256059356,0.571151
371,72,26712,146275330,256059356,0.571256
372,66,24552,146299882,256059356,0.571351
373,58,21634,146321516,256059356,0.571436
374,64,23936,146345452,256059356,0.571529
375,72,27000,146372452,256059356,0.571635
376,67,25192,146397644,256059356,0.571733
377,60,22620,146420264,256059356,0.571822
378,76,28728,146448992,256059356,0.571934
379,72,27288,146476280,256059356,0.57204
380,79,30020,146506300,256059356,0.572158
381,63,24003,146530303,256059356,0.572251
382,70,26740,146557043,256059356,0.572356
383,47,18001,146575044,256059356,0.572426
384,68,26112,146601156,256059356,0.572528
385,54,20790,146621946,256059356,0.572609
386,54,20844,146642790,256059356,0.572691
387,55,21285,146664075,256059356,0.572774
388,44,17072,146681147,256059356,0.57284
389,44,17116,146698263,256059356,0.572907
390,61,23790,146722053,256059356,0.573
391,50,19550,146741603,256059356,0.573077
392,64,25088,146766691,256059356,0.573174
393,78,30654,146797345,256059356,0.573294
394,63,24822,146822167,256059356,0.573391
395,49,19355,146841522,256059356,0.573467
396,54,21384,146862906,256059356,0.57355
397,66,26202,146889108,256059356,0.573653
398,62,24676,146913784,256059356,0.573749
399,48,19152,146932936,256059356,0.573824
400,59,23600,146956536,256059356,0.573916
401,50,20050,146976586,256059356,0.573994
402,48,19296,146995882,256059356,0.57407
403,54,21762,147017644,256059356,0.574155
404,52,21008,147038652,256059356,0.574237
405,51,20655,147059307,256059356,0.574317
406,67,27202,147086509,256059356,0.574423
407,50,20350,147106859,256059356,0.574503
408,52,21216,147128075,256059356,0.574586
409,57,23313,147151388,256059356,0.574677
410,39,15990,147167378,256059356,0.574739
411,46,18906,147186284,256059356,0.574813
412,59,24308,147210592,256059356,0.574908
413,45,18585,147229177,256059356,0.574981
414,56,23184,147252361,256059356,0.575071
415,52,21580,147273941,256059356,0.575155
416,50,20800,147294741,256059356,0.575237
417,57,23769,147318510,256059356,0.57533
418,57,23826,147342336,256059356,0.575423
419,39,16341,147358677,256059356,0.575486
420,51,21420,147380097,256059356,0.57557
421,51,21471,147401568,256059356,0.575654
422,48,20256,147421824,256059356,0.575733
423,53,22419,147444243,256059356,0.575821
424,55,23320,147467563,256059356,0.575912
425,49,20825,147488388,256059356,0.575993
426,50,21300,147509688,256059356,0.576076
427,62,26474,147536162,256059356,0.57618
428,55,23540,147559702,256059356,0.576271
429,39,16731,147576433,256059356,0.576337
430,61,26230,147602663,256059356,0.576439
431,50,21550,147624213,256059356,0.576523
432,53,22896,147647109,256059356,0.576613
433,66,28578,147675687,256059356,0.576724
434,63,27342,147703029,256059356,0.576831
435,33,14355,147717384,256059356,0.576887
436,41,17876,147735260,256059356,0.576957
437,50,21850,147757110,256059356,0.577042
438,56,24528,147781638,256059356,0.577138
439,47,20633,147802271,256059356,0.577219
440,34,14960,147817231,256059356,0.577277
441,38,16758,147833989,256059356,0.577343
442,42,18564,147852553,256059356,0.577415
443,46,20378,147872931,256059356,0.577495
444,46,20424,147893355,256059356,0.577575
445,46,20470,147913825,256059356,0.577654
446,39,17394,147931219,256059356,0.577722
447,43,19221,147950440,256059356,0.577797
448,42,18816,147969256,256059356,0.577871
449,58,26042,147995298,256059356,0.577973
450,42,18900,148014198,256059356,0.578046
451,28,12628,148026826,256059356,0.578096
452,48,21696,148048522,256059356,0.57818
453,63,28539,148077061,256059356,0.578292
454,57,25878,148102939,256059356,0.578393
455,46,20930,148123869,256059356,0.578475
456,32,14592,148138461,256059356,0.578532
457,36,16452,148154913,256059356,0.578596
458,44,20152,148175065,256059356,0.578675
459,50,22950,148198015,256059356,0.578764
460,47,21620,148219635,256059356,0.578849
461,41,18901,148238536,256059356,0.578923
462,42,19404,148257940,256059356,0.578998
463,41,18983,148276923,256059356,0.579072
464,40,18560,148295483,256059356,0.579145
465,68,31620,148327103,256059356,0.579268
466,48,22368,148349471,256059356,0.579356
467,39,18213,148367684,256059356,0.579427
468,38,17784,148385468,256059356,0.579496
469,41,19229,148404697,256059356,0.579571
470,47,22090,148426787,256059356,0.579658
471,47,22137,148448924,256059356,0.579744
472,49,23128,148472052,256059356,0.579835
473,30,14190,148486242,256059356,0.57989
474,30,14220,148500462,256059356,0.579945
475,30,14250,148514712,256059356,0.580001
476,37,17612,148532324,256059356,0.58007
477,36,17172,148549496,256059356,0.580137
478,39,18642,148568138,256059356,0.58021
479,43,20597,148588735,256059356,0.58029
480,42,20160,148608895,256059356,0.580369
481,44,21164,148630059,256059356,0.580452
482,43,20726,148650785,256059356,0.580533
483,32,15456,148666241,256059356,0.580593
484,38,18392,148684633,256059356,0.580665
485,39,18915,148703548,256059356,0.580739
486,39,18954,148722502,256059356,0.580813
487,41,19967,148742469,256059356,0.580891
488,44,21472,148763941,256059356,0.580974
489,39,19071,148783012,256059356,0.581049
490,28,13720,148796732,256059356,0.581103
491,39,19149,148815881,256059356,0.581177
492,47,23124,148839005,256059356,0.581268
493,38,18734,148857739,256059356,0.581341
494,40,19760,148877499,256059356,0.581418
495,44,21780,148899279,256059356,0.581503
496,34,16864,148916143,256059356,0.581569
497,36,17892,148934035,256059356,0.581639
498,34,16932,148950967,256059356,0.581705
499,36,17964,148968931,256059356,0.581775
500,47,23500,148992431,256059356,0.581867
501,45,22545,149014976,256059356,0.581955
502,41,20582,149035558,256059356,0.582035
503,33,16599,149052157,256059356,0.5821
504,28,14112,149066269,256059356,0.582155
505,35,17675,149083944,256059356,0.582224
506,36,18216,149102160,256059356,0.582295
507,36,18252,149120412,256059356,0.582367
508,43,21844,149142256,256059356,0.582452
509,34,17306,149159562,256059356,0.582519
510,37,18870,149178432,256059356,0.582593
511,39,19929,149198361,256059356,0.582671
512,35,17920,149216281,256059356,0.582741
513,34,17442,149233723,256059356,0.582809
514,32,16448,149250171,256059356,0.582873
515,41,21115,149271286,256059356,0.582956
516,30,15480,149286766,256059356,0.583016
517,34,17578,149304344,256059356,0.583085
518,25,12950,149317294,256059356,0.583135
519,33,17127,149334421,256059356,0.583202
520,38,19760,149354181,256059356,0.58328
521,38,19798,149373979,256059356,0.583357
522,34,17748,149391727,256059356,0.583426
523,31,16213,149407940,256059356,0.583489
524,30,15720,149423660,256059356,0.583551
525,21,11025,149434685,256059356,0.583594
526,32,16832,149451517,256059356,0.58366
527,28,14756,149466273,256059356,0.583717
528,29,15312,149481585,256059356,0.583777
529,32,16928,149498513,256059356,0.583843
530,30,15900,149514413,256059356,0.583905
531,31,16461,149530874,256059356,0.58397
532,21,11172,149542046,256059356,0.584013
533,22,11726,149553772,256059356,0.584059
534,38,20292,149574064,256059356,0.584138
535,33,17655,149591719,256059356,0.584207
536,25,13400,149605119,256059356,0.58426
537,30,16110,149621229,256059356,0.584322
538,31,16678,149637907,256059356,0.584388
539,25,13475,149651382,256059356,0.58444
540,17,9180,149660562,256059356,0.584476
541,33,17853,149678415,256059356,0.584546
542,28,15176,149693591,256059356,0.584605
543,21,11403,149704994,256059356,0.58465
544,37,20128,149725122,256059356,0.584728
545,45,24525,149749647,256059356,0.584824
546,24,13104,149762751,256059356,0.584875
547,35,19145,149781896,256059356,0.58495
548,29,15892,149797788,256059356,0.585012
549,31,17019,149814807,256059356,0.585078
550,28,15400,149830207,256059356,0.585139
551,33,18183,149848390,256059356,0.58521
552,32,17664,149866054,256059356,0.585279
553,48,26544,149892598,256059356,0.585382
554,43,23822,149916420,256059356,0.585475
555,28,15540,149931960,256059356,0.585536
556,27,15012,149946972,256059356,0.585595
557,33,18381,149965353,256059356,0.585666
558,29,16182,149981535,256059356,0.58573
559,42,23478,150005013,256059356,0.585821
560,30,16800,150021813,256059356,0.585887
561,35,19635,150041448,256059356,0.585964
562,32,17984,150059432,256059356,0.586034
563,40,22520,150081952,256059356,0.586122
564,25,14100,150096052,256059356,0.586177
565,22,12430,150108482,256059356,0.586225
566,31,17546,150126028,256059356,0.586294
567,46,26082,150152110,256059356,0.586396
568,38,21584,150173694,256059356,0.58648
569,23,13087,150186781,256059356,0.586531
570,20,11400,150198181,256059356,0.586576
571,25,14275,150212456,256059356,0.586631
572,30,17160,150229616,256059356,0.586698
573,27,15471,150245087,256059356,0.586759
574,33,18942,150264029,256059356,0.586833
575,33,18975,150283004,256059356,0.586907
576,30,17280,150300284,256059356,0.586974
577,34,19618,150319902,256059356,0.587051
578,21,12138,150332040,256059356,0.587098
579,29,16791,150348831,256059356,0.587164
580,23,13340,150362171,256059356,0.587216
581,31,18011,150380182,256059356,0.587286
582,26,15132,150395314,256059356,0.587346
583,21,12243,150407557,256059356,0.587393
584,25,14600,150422157,256059356,0.58745
585,32,18720,150440877,256059356,0.587523
586,24,14064,150454941,256059356,0.587578
587,31,18197,150473138,256059356,0.587649
588,23,13524,150486662,256059356,0.587702
589,25,14725,150501387,256059356,0.58776
590,28,16520,150517907,256059356,0.587824
591,29,17139,150535046,256059356,0.587891
592,30,17760,150552806,256059356,0.587961
593,36,21348,150574154,256059356,0.588044
594,24,14256,150588410,256059356,0.5881
595,32,19040,150607450,256059356,0.588174
596,31,18476,150625926,256059356,0.588246
597,22,13134,150639060,256059356,0.588297
598,27,16146,150655206,256059356,0.58836
599,27,16173,150671379,256059356,0.588424
600,27,16200,150687579,256059356,0.588487
601,25,15025,150702604,256059356,0.588546
602,24,14448,150717052,256059356,0.588602
603,36,21708,150738760,256059356,0.588687
604,25,15100,150753860,256059356,0.588746
605,31,18755,150772615,256059356,0.588819
606,25,15150,150787765,256059356,0.588878
607,32,19424,150807189,256059356,0.588954
608,27,16416,150823605,256059356,0.589018
609,21,12789,150836394,256059356,0.589068
610,23,14030,150850424,256059356,0.589123
611,21,12831,150863255,256059356,0.589173
612,22,13464,150876719,256059356,0.589226
613,14,8582,150885301,256059356,0.589259
614,20,12280,150897581,256059356,0.589307
615,23,14145,150911726,256059356,0.589362
616,18,11088,150922814,256059356,0.589406
617,25,15425,150938239,256059356,0.589466
618,20,12360,150950599,256059356,0.589514
619,25,15475,150966074,256059356,0.589575
620,26,16120,150982194,256059356,0.589637
621,19,11799,150993993,256059356,0.589684
622,24,14928,151008921,256059356,0.589742
623,29,18067,151026988,256059356,0.589812
624,14,8736,151035724,256059356,0.589847
625,22,13750,151049474,256059356,0.5899
626,20,12520,151061994,256059356,0.589949
627,19,11913,151073907,256059356,0.589996
628,27,16956,151090863,256059356,0.590062
629,28,17612,151108475,256059356,0.590131
630,16,10080,151118555,256059356,0.59017
631,31,19561,151138116,256059356,0.590246
632,30,18960,151157076,256059356,0.59032
633,23,14559,151171635,256059356,0.590377
634,27,17118,151188753,256059356,0.590444
635,17,10795,151199548,256059356,0.590486
636,28,17808,151217356,256059356,0.590556
637,21,13377,151230733,256059356,0.590608
638,28,17864,151248597,256059356,0.590678
639,16,10224,151258821,256059356,0.590718
640,22,14080,151272901,256059356,0.590773
641,23,14743,151287644,256059356,0.59083
642,16,10272,151297916,256059356,0.59087
643,22,14146,151312062,256059356,0.590926
644,23,14812,151326874,256059356,0.590984
645,26,16770,151343644,256059356,0.591049
646,16,10336,151353980,256059356,0.591089
647,24,15528,151369508,256059356,0.59115
648,24,15552,151385060,256059356,0.591211
649,26,16874,151401934,256059356,0.591277
650,22,14300,151416234,256059356,0.591333
651,8,5208,151421442,256059356,0.591353
652,28,18256,151439698,256059356,0.591424
653,19,12407,151452105,256059356,0.591473
654,14,9156,151461261,256059356,0.591508
655,25,16375,151477636,256059356,0.591572
656,26,17056,151494692,256059356,0.591639
657,22,14454,151509146,256059356,0.591695
658,9,5922,151515068,256059356,0.591719
659,17,11203,151526271,256059356,0.591762
660,18,11880,151538151,256059356,0.591809
661,18,11898,151550049,256059356,0.591855
662,19,12578,151562627,256059356,0.591904
663,20,13260,151575887,256059356,0.591956
664,16,10624,151586511,256059356,0.591998
665,20,13300,151599811,256059356,0.592049
666,21,13986,151613797,256059356,0.592104
667,22,14674,151628471,256059356,0.592161
668,17,11356,151639827,256059356,0.592206
669,15,10035,151649862,256059356,0.592245
670,24,16080,151665942,256059356,0.592308
671,17,11407,151677349,256059356,0.592352
672,18,12096,151689445,256059356,0.5924
673,22,14806,151704251,256059356,0.592457
674,17,11458,151715709,256059356,0.592502
675,25,16875,151732584,256059356,0.592568
676,17,11492,151744076,256059356,0.592613
677,17,11509,151755585,256059356,0.592658
678,24,16272,151771857,256059356,0.592721
679,19,12901,151784758,256059356,0.592772
680,18,12240,151796998,256059356,0.59282
681,14,9534,151806532,256059356,0.592857
682,25,17050,151823582,256059356,0.592923
683,19,12977,151836559,256059356,0.592974
684,19,12996,151849555,256059356,0.593025
685,11,7535,151857090,256059356,0.593054
686,21,14406,151871496,256059356,0.593111
687,16,10992,151882488,256059356,0.593153
688,14,9632,151892120,256059356,0.593191
689,16,11024,151903144,256059356,0.593234
690,14,9660,151912804,256059356,0.593272
691,11,7601,151920405,256059356,0.593302
692,18,12456,151932861,256059356,0.59335
693,22,15246,151948107,256059356,0.59341
694,23,15962,151964069,256059356,0.593472
695,16,11120,151975189,256059356,0.593515
696,12,8352,151983541,256059356,0.593548
697,19,13243,151996784,256059356,0.5936
698,21,14658,152011442,256059356,0.593657
699,21,14679,152026121,256059356,0.593714
700,16,11200,152037321,256059356,0.593758
701,23,16123,152053444,256059356,0.593821
702,17,11934,152065378,256059356,0.593868
703,20,14060,152079438,256059356,0.593923
704,20,14080,152093518,256059356,0.593978
705,21,14805,152108323,256059356,0.594035
706,24,16944,152125267,256059356,0.594102
707,14,9898,152135165,256059356,0.59414
708,21,14868,152150033,256059356,0.594198
709,14,9926,152159959,256059356,0.594237
710,20,14200,152174159,256059356,0.594293
711,16,11376,152185535,256059356,0.594337
712,22,15664,152201199,256059356,0.594398
713,17,12121,152213320,256059356,0.594445
714,17,12138,152225458,256059356,0.594493
715,16,11440,152236898,256059356,0.594538
716,15,10740,152247638,256059356,0.594579
717,14,10038,152257676,256059356,0.594619
718,16,11488,152269164,256059356,0.594664
719,17,12223,152281387,256059356,0.594711
720,18,12960,152294347,256059356,0.594762
721,19,13699,152308046,256059356,0.594815
722,13,9386,152317432,256059356,0.594852
723,13,9399,152326831,256059356,0.594889
724,18,13032,152339863,256059356,0.59494
725,19,13775,152353638,256059356,0.594993
726,25,18150,152371788,256059356,0.595064
727,23,16721,152388509,256059356,0.59513
728,16,11648,152400157,256059356,0.595175
729,24,17496,152417653,256059356,0.595243
730,18,13140,152430793,256059356,0.595295
731,23,16813,152447606,256059356,0.59536
732,25,18300,152465906,256059356,0.595432
733,12,8796,152474702,256059356,0.595466
734,13,9542,152484244,256059356,0.595504
735,17,12495,152496739,256059356,0.595552
736,22,16192,152512931,256059356,0.595616
737,13,9581,152522512,256059356,0.595653
738,23,16974,152539486,256059356,0.595719
739,13,9607,152549093,256059356,0.595757
740,21,15540,152564633,256059356,0.595817
741,17,12597,152577230,256059356,0.595867
742,13,9646,152586876,256059356,0.595904
743,16,11888,152598764,256059356,0.595951
744,14,10416,152609180,256059356,0.595991
745,20,14900,152624080,256059356,0.59605
746,15,11190,152635270,256059356,0.596093
747,17,12699,152647969,256059356,0.596143
748,16,11968,152659937,256059356,0.59619
749,18,13482,152673419,256059356,0.596242
750,20,15000,152688419,256059356,0.596301
751,13,9763,152698182,256059356,0.596339
752,12,9024,152707206,256059356,0.596374
753,18,13554,152720760,256059356,0.596427
754,16,12064,152732824,256059356,0.596474
755,26,19630,152752454,256059356,0.596551
756,11,8316,152760770,256059356,0.596583
757,18,13626,152774396,256059356,0.596637
758,11,8338,152782734,256059356,0.596669
759,16,12144,152794878,256059356,0.596717
760,13,9880,152804758,256059356,0.596755
761,16,12176,152816934,256059356,0.596803
762,18,13716,152830650,256059356,0.596856
763,13,9919,152840569,256059356,0.596895
764,14,10696,152851265,256059356,0.596937
765,17,13005,152864270,256059356,0.596988
766,19,14554,152878824,256059356,0.597044
767,16,12272,152891096,256059356,0.597092
768,17,13056,152904152,256059356,0.597143
769,20,15380,152919532,256059356,0.597203
770,24,18480,152938012,256059356,0.597276
771,23,17733,152955745,256059356,0.597345
772,16,12352,152968097,256059356,0.597393
773,19,14687,152982784,256059356,0.59745
774,11,8514,152991298,256059356,0.597484
775,14,10850,153002148,256059356,0.597526
776,14,10864,153013012,256059356,0.597569
777,17,13209,153026221,256059356,0.59762
778,20,15560,153041781,256059356,0.597681
779,14,10906,153052687,256059356,0.597723
780,21,16380,153069067,256059356,0.597787
781,14,10934,153080001,256059356,0.59783
782,12,9384,153089385,256059356,0.597867
783,15,11745,153101130,256059356,0.597913
784,15,11760,153112890,256059356,0.597959
785,17,13345,153126235,256059356,0.598011
786,11,8646,153134881,256059356,0.598044
787,13,10231,153145112,256059356,0.598084
788,12,9456,153154568,256059356,0.598121
789,14,11046,153165614,256059356,0.598164
790,12,9480,153175094,256059356,0.598202
791,18,14238,153189332,256059356,0.598257
792,20,15840,153205172,256059356,0.598319
793,14,11102,153216274,256059356,0.598362
794,12,9528,153225802,256059356,0.5984
795,11,8745,153234547,256059356,0.598434
796,15,11940,153246487,256059356,0.59848
797,15,11955,153258442,256059356,0.598527
798,15,11970,153270412,256059356,0.598574
799,14,11186,153281598,256059356,0.598617
800,27,21600,153303198,256059356,0.598702
801,11,8811,153312009,256059356,0.598736
802,22,17644,153329653,256059356,0.598805
803,18,14454,153344107,256059356,0.598862
804,17,13668,153357775,256059356,0.598915
805,12,9660,153367435,256059356,0.598953
806,14,11284,153378719,256059356,0.598997
807,18,14526,153393245,256059356,0.599053
808,17,13736,153406981,256059356,0.599107
809,10,8090,153415071,256059356,0.599139
810,14,11340,153426411,256059356,0.599183
811,10,8110,153434521,256059356,0.599215
812,13,10556,153445077,256059356,0.599256
813,19,15447,153460524,256059356,0.599316
814,17,13838,153474362,256059356,0.59937
815,16,13040,153487402,256059356,0.599421
816,12,9792,153497194,256059356,0.599459
817,15,12255,153509449,256059356,0.599507
818,11,8998,153518447,256059356,0.599542
819,14,11466,153529913,256059356,0.599587
820,18,14760,153544673,256059356,0.599645
821,10,8210,153552883,256059356,0.599677
822,18,14796,153567679,256059356,0.599735
823,12,9876,153577555,256059356,0.599773
824,15,12360,153589915,256059356,0.599822
825,15,12375,153602290,256059356,0.59987
826,12,9912,153612202,256059356,0.599909
827,15,12405,153624607,256059356,0.599957
828,12,9936,153634543,256059356,0.599996
829,14,11606,153646149,256059356,0.600041
830,11,9130,153655279,256059356,0.600077
831,17,14127,153669406,256059356,0.600132
832,11,9152,153678558,256059356,0.600168
833,17,14161,153692719,256059356,0.600223
834,11,9174,153701893,256059356,0.600259
835,13,10855,153712748,256059356,0.600301
836,11,9196,153721944,256059356,0.600337
837,12,10044,153731988,256059356,0.600376
838,18,15084,153747072,256059356,0.600435
839,13,10907,153757979,256059356,0.600478
840,17,14280,153772259,256059356,0.600534
841,16,13456,153785715,256059356,0.600586
842,11,9262,153794977,256059356,0.600622
843,9,7587,153802564,256059356,0.600652
844,13,10972,153813536,256059356,0.600695
845,5,4225,153817761,256059356,0.600711
846,11,9306,153827067,256059356,0.600748
847,11,9317,153836384,256059356,0.600784
848,13,11024,153847408,256059356,0.600827
849,23,19527,153866935,256059356,0.600903
850,20,17000,153883935,256059356,0.60097
851,17,14467,153898402,256059356,0.601026
852,18,15336,153913738,256059356,0.601086
853,15,12795,153926533,256059356,0.601136
854,18,15372,153941905,256059356,0.601196
855,24,20520,153962425,256059356,0.601276
856,16,13696,153976121,256059356,0.60133
857,16,13712,153989833,256059356,0.601383
858,11,9438,153999271,256059356,0.60142
859,12,10308,154009579,256059356,0.60146
860,23,19780,154029359,256059356,0.601538
861,17,14637,154043996,256059356,0.601595
862,21,18102,154062098,256059356,0.601666
863,11,9493,154071591,256059356,0.601703
864,13,11232,154082823,256059356,0.601747
865,15,12975,154095798,256059356,0.601797
866,5,4330,154100128,256059356,0.601814
867,11,9537,154109665,256059356,0.601851
868,13,11284,154120949,256059356,0.601895
869,17,14773,154135722,256059356,0.601953
870,17,14790,154150512,256059356,0.602011
871,11,9581,154160093,256059356,0.602048
872,13,11336,154171429,256059356,0.602093
873,14,12222,154183651,256059356,0.60214
874,9,7866,154191517,256059356,0.602171
875,4,3500,154195017,256059356,0.602185
876,17,14892,154209909,256059356,0.602243
877,10,8770,154218679,256059356,0.602277
878,8,7024,154225703,256059356,0.602305
879,16,14064,154239767,256059356,0.602359
880,12,10560,154250327,256059356,0.602401
881,10,8810,154259137,256059356,0.602435
882,16,14112,154273249,256059356,0.60249
883,14,12362,154285611,256059356,0.602538
884,9,7956,154293567,256059356,0.60257
885,13,11505,154305072,256059356,0.602614
886,15,13290,154318362,256059356,0.602666
887,8,7096,154325458,256059356,0.602694
888,17,15096,154340554,256059356,0.602753
889,23,20447,154361001,256059356,0.602833
890,10,8900,154369901,256059356,0.602868
891,14,12474,154382375,256059356,0.602916
892,20,17840,154400215,256059356,0.602986
893,7,6251,154406466,256059356,0.60301
894,13,11622,154418088,256059356,0.603056
895,9,8055,154426143,256059356,0.603087
896,11,9856,154435999,256059356,0.603126
897,13,11661,154447660,256059356,0.603171
898,10,8980,154456640,256059356,0.603206
899,15,13485,154470125,256059356,0.603259
900,15,13500,154483625,256059356,0.603312
901,12,10812,154494437,256059356,0.603354
902,12,10824,154505261,256059356,0.603396
903,17,15351,154520612,256059356,0.603456
904,13,11752,154532364,256059356,0.603502
905,12,10860,154543224,256059356,0.603545
906,4,3624,154546848,256059356,0.603559
907,12,10884,154557732,256059356,0.603601
908,12,10896,154568628,256059356,0.603644
909,11,9999,154578627,256059356,0.603683
910,9,8190,154586817,256059356,0.603715
911,10,9110,154595927,256059356,0.60375
912,7,6384,154602311,256059356,0.603775
913,10,9130,154611441,256059356,0.603811
914,7,6398,154617839,256059356,0.603836
915,15,13725,154631564,256059356,0.60389
916,11,10076,154641640,256059356,0.603929
917,11,10087,154651727,256059356,0.603968
918,10,9180,154660907,256059356,0.604004
919,7,6433,154667340,256059356,0.604029
920,7,6440,154673780,256059356,0.604054
921,13,11973,154685753,256059356,0.604101
922,14,12908,154698661,256059356,0.604152
923,11,10153,154708814,256059356,0.604191
924,6,5544,154714358,256059356,0.604213
925,6,5550,154719908,256059356,0.604235
926,11,10186,154730094,256059356,0.604274
927,17,15759,154745853,256059356,0.604336
928,6,5568,154751421,256059356,0.604358
929,5,4645,154756066,256059356,0.604376
930,12,11160,154767226,256059356,0.604419
931,5,4655,154771881,256059356,0.604438
932,6,5592,154777473,256059356,0.604459
933,11,10263,154787736,256059356,0.604499
934,8,7472,154795208,256059356,0.604529
935,12,11220,154806428,256059356,0.604572
936,12,11232,154817660,256059356,0.604616
937,9,8433,154826093,256059356,0.604649
938,7,6566,154832659,256059356,0.604675
939,12,11268,154843927,256059356,0.604719
940,2,1880,154845807,256059356,0.604726
941,8,7528,154853335,256059356,0.604756
942,5,4710,154858045,256059356,0.604774
943,15,14145,154872190,256059356,0.604829
944,11,10384,154882574,256059356,0.60487
945,10,9450,154892024,256059356,0.604907
946,9,8514,154900538,256059356,0.60494
947,11,10417,154910955,256059356,0.604981
948,19,18012,154928967,256059356,0.605051
949,21,19929,154948896,256059356,0.605129
950,14,13300,154962196,256059356,0.605181
951,8,7608,154969804,256059356,0.60521
952,12,11424,154981228,256059356,0.605255
953,12,11436,154992664,256059356,0.6053
954,10,9540,155002204,256059356,0.605337
955,15,14325,155016529,256059356,0.605393
956,12,11472,155028001,256059356,0.605438
957,7,6699,155034700,256059356,0.605464
958,7,6706,155041406,256059356,0.60549
959,18,17262,155058668,256059356,0.605558
960,9,8640,155067308,256059356,0.605591
961,16,15376,155082684,256059356,0.605651
962,11,10582,155093266,256059356,0.605693
963,13,12519,155105785,256059356,0.605742
964,15,14460,155120245,256059356,0.605798
965,13,12545,155132790,256059356,0.605847
966,22,21252,155154042,256059356,0.60593
967,10,9670,155163712,256059356,0.605968
968,10,9680,155173392,256059356,0.606006
969,11,10659,155184051,256059356,0.606047
970,13,12610,155196661,256059356,0.606096
971,8,7768,155204429,256059356,0.606127
972,7,6804,155211233,256059356,0.606153
973,9,8757,155219990,256059356,0.606188
974,7,6818,155226808,256059356,0.606214
975,14,13650,155240458,256059356,0.606267
976,10,9760,155250218,256059356,0.606306
977,3,2931,155253149,256059356,0.606317
978,10,9780,155262929,256059356,0.606355
979,7,6853,155269782,256059356,0.606382
980,9,8820,155278602,256059356,0.606416
981,7,6867,155285469,256059356,0.606443
982,6,5892,155291361,256059356,0.606466
983,11,10813,155302174,256059356,0.606508
984,10,9840,155312014,256059356,0.606547
985,6,5910,155317924,256059356,0.60657
986,7,6902,155324826,256059356,0.606597
987,11,10857,155335683,256059356,0.606639
988,9,8892,155344575,256059356,0.606674
989,4,3956,155348531,256059356,0.60669
990,7,6930,155355461,256059356,0.606717
991,11,10901,155366362,256059356,0.606759
992,17,16864,155383226,256059356,0.606825
993,8,7944,155391170,256059356,0.606856
994,5,4970,155396140,256059356,0.606875
995,9,8955,155405095,256059356,0.60691
996,8,7968,155413063,256059356,0.606942
997,12,11964,155425027,256059356,0.606988
998,9,8982,155434009,256059356,0.607023
999,10,9990,155443999,256059356,0.607062
1000,32,32000,155475999,256059356,0.607187
1001,23,23023,155499022,256059356,0.607277
1002,13,13026,155512048,256059356,0.607328
1003,15,15045,155527093,256059356,0.607387
1004,18,18072,155545165,256059356,0.607457
1005,12,12060,155557225,256059356,0.607505
1006,9,9054,155566279,256059356,0.60754
1007,7,7049,155573328,256059356,0.607567
1008,8,8064,155581392,256059356,0.607599
1009,16,16144,155597536,256059356,0.607662
1010,10,10100,155607636,256059356,0.607701
1011,6,6066,155613702,256059356,0.607725
1012,12,12144,155625846,256059356,0.607773
1013,12,12156,155638002,256059356,0.60782
1014,10,10140,155648142,256059356,0.60786
1015,6,6090,155654232,256059356,0.607883
1016,8,8128,155662360,256059356,0.607915
1017,19,19323,155681683,256059356,0.607991
1018,7,7126,155688809,256059356,0.608018
1019,7,7133,155695942,256059356,0.608046
1020,5,5100,155701042,256059356,0.608066
1021,12,12252,155713294,256059356,0.608114
1022,10,10220,155723514,256059356,0.608154
1023,7,7161,155730675,256059356,0.608182
1024,4,4096,155734771,256059356,0.608198
1025,5,5125,155739896,256059356,0.608218
1026,7,7182,155747078,256059356,0.608246
1027,5,5135,155752213,256059356,0.608266
1028,6,6168,155758381,256059356,0.60829
1029,9,9261,155767642,256059356,0.608326
1030,14,14420,155782062,256059356,0.608383
1031,8,8248,155790310,256059356,0.608415
1032,2,2064,155792374,256059356,0.608423
1033,8,8264,155800638,256059356,0.608455
1034,12,12408,155813046,256059356,0.608504
1035,8,8280,155821326,256059356,0.608536
1036,9,9324,155830650,256059356,0.608572
1037,6,6222,155836872,256059356,0.608597
1038,6,6228,155843100,256059356,0.608621
1039,10,10390,155853490,256059356,0.608662
1040,9,9360,155862850,256059356,0.608698
1041,10,10410,155873260,256059356,0.608739
1042,13,13546,155886806,256059356,0.608792
1043,9,9387,155896193,256059356,0.608828
1044,8,8352,155904545,256059356,0.608861
1045,10,10450,155914995,256059356,0.608902
1046,13,13598,155928593,256059356,0.608955
1047,14,14658,155943251,256059356,0.609012
1048,18,18864,155962115,256059356,0.609086
1049,6,6294,155968409,256059356,0.60911
1050,10,10500,155978909,256059356,0.609151
1051,12,12612,155991521,256059356,0.609201
1052,11,11572,156003093,256059356,0.609246
1053,9,9477,156012570,256059356,0.609283
1054,15,15810,156028380,256059356,0.609345
1055,8,8440,156036820,256059356,0.609378
1056,8,8448,156045268,256059356,0.609411
1057,8,8456,156053724,256059356,0.609444
1058,13,13754,156067478,256059356,0.609497
1059,14,14826,156082304,256059356,0.609555
1060,10,10600,156092904,256059356,0.609597
1061,8,8488,156101392,256059356,0.60963
1062,9,9558,156110950,256059356,0.609667
1063,6,6378,156117328,256059356,0.609692
1064,13,13832,156131160,256059356,0.609746
1065,6,6390,156137550,256059356,0.609771
1066,16,17056,156154606,256059356,0.609838
1067,4,4268,156158874,256059356,0.609854
1068,9,9612,156168486,256059356,0.609892
1069,5,5345,156173831,256059356,0.609913
1070,14,14980,156188811,256059356,0.609971
1071,8,8568,156197379,256059356,0.610005
1072,6,6432,156203811,256059356,0.61003
1073,12,12876,156216687,256059356,0.61008
1074,16,17184,156233871,256059356,0.610147
1075,4,4300,156238171,256059356,0.610164
1076,18,19368,156257539,256059356,0.61024
1077,17,18309,156275848,256059356,0.610311
1078,12,12936,156288784,256059356,0.610362
1079,9,9711,156298495,256059356,0.610399
1080,14,15120,156313615,256059356,0.610459
1081,10,10810,156324425,256059356,0.610501
1082,20,21640,156346065,256059356,0.610585
1083,9,9747,156355812,256059356,0.610623
1084,7,7588,156363400,256059356,0.610653
1085,13,14105,156377505,256059356,0.610708
1086,11,11946,156389451,256059356,0.610755
1087,5,5435,156394886,256059356,0.610776
1088,14,15232,156410118,256059356,0.610835
1089,7,7623,156417741,256059356,0.610865
1090,16,17440,156435181,256059356,0.610933
1091,8,8728,156443909,256059356,0.610967
1092,6,6552,156450461,256059356,0.610993
1093,5,5465,156455926,256059356,0.611014
1094,17,18598,156474524,256059356,0.611087
1095,13,14235,156488759,256059356,0.611143
1096,8,8768,156497527,256059356,0.611177
1097,11,12067,156509594,256059356,0.611224
1098,13,14274,156523868,256059356,0.61128
1099,11,12089,156535957,256059356,0.611327
1100,9,9900,156545857,256059356,0.611366
1101,9,9909,156555766,256059356,0.611404
1102,10,11020,156566786,256059356,0.611447
1103,8,8824,156575610,256059356,0.611482
1104,7,7728,156583338,256059356,0.611512
1105,11,12155,156595493,256059356,0.611559
1106,14,15484,156610977,256059356,0.61162
1107,10,11070,156622047,256059356,0.611663
1108,6,6648,156628695,256059356,0.611689
1109,15,16635,156645330,256059356,0.611754
1110,3,3330,156648660,256059356,0.611767
1111,8,8888,156657548,256059356,0.611802
1112,8,8896,156666444,256059356,0.611836
1113,19,21147,156687591,256059356,0.611919
1114,4,4456,156692047,256059356,0.611936
1115,11,12265,156704312,256059356,0.611984
1116,8,8928,156713240,256059356,0.612019
1117,14,15638,156728878,256059356,0.61208
1118,10,11180,156740058,256059356,0.612124
1119,7,7833,156747891,256059356,0.612155
1120,14,15680,156763571,256059356,0.612216
1121,10,11210,156774781,256059356,0.61226
1122,15,16830,156791611,256059356,0.612325
1123,8,8984,156800595,256059356,0.61236
1124,13,14612,156815207,256059356,0.612417
1125,6,6750,156821957,256059356,0.612444
1126,6,6756,156828713,256059356,0.61247
1127,10,11270,156839983,256059356,0.612514
1128,11,12408,156852391,256059356,0.612563
1129,11,12419,156864810,256059356,0.612611
1130,6,6780,156871590,256059356,0.612638
1131,10,11310,156882900,256059356,0.612682
1132,4,4528,156887428,256059356,0.612699
1133,12,13596,156901024,256059356,0.612753
1134,8,9072,156910096,256059356,0.612788
1135,6,6810,156916906,256059356,0.612815
1136,9,10224,156927130,256059356,0.612855
1137,6,6822,156933952,256059356,0.612881
1138,14,15932,156949884,256059356,0.612943
1139,13,14807,156964691,256059356,0.613001
1140,12,13680,156978371,256059356,0.613055
1141,10,11410,156989781,256059356,0.613099
1142,8,9136,156998917,256059356,0.613135
1143,6,6858,157005775,256059356,0.613162
1144,13,14872,157020647,256059356,0.61322
1145,7,8015,157028662,256059356,0.613251
1146,5,5730,157034392,256059356,0.613273
1147,1,1147,157035539,256059356,0.613278
1148,7,8036,157043575,256059356,0.613309
1149,13,14937,157058512,256059356,0.613368
1150,8,9200,157067712,256059356,0.613404
1151,10,11510,157079222,256059356,0.613448
1152,7,8064,157087286,256059356,0.61348
1153,10,11530,157098816,256059356,0.613525
1154,11,12694,157111510,256059356,0.613575
1155,4,4620,157116130,256059356,0.613593
1156,7,8092,157124222,256059356,0.613624
1157,10,11570,157135792,256059356,0.613669
1158,13,15054,157150846,256059356,0.613728
1159,7,8113,157158959,256059356,0.61376
1160,9,10440,157169399,256059356,0.613801
1161,8,9288,157178687,256059356,0.613837
1162,12,13944,157192631,256059356,0.613891
1163,8,9304,157201935,256059356,0.613928
1164,6,6984,157208919,256059356,0.613955
1165,6,6990,157215909,256059356,0.613982
1166,8,9328,157225237,256059356,0.614019
1167,4,4668,157229905,256059356,0.614037
1168,14,16352,157246257,256059356,0.614101
1169,10,11690,157257947,256059356,0.614146
1170,6,7020,157264967,256059356,0.614174
1171,6,7026,157271993,256059356,0.614201
1172,11,12892,157284885,256059356,0.614252
1173,15,17595,157302480,256059356,0.61432
1174,8,9392,157311872,256059356,0.614357
1175,10,11750,157323622,256059356,0.614403
1176,10,11760,157335382,256059356,0.614449
1177,8,9416,157344798,256059356,0.614486
1178,13,15314,157360112,256059356,0.614545
1179,9,10611,157370723,256059356,0.614587
1180,12,14160,157384883,256059356,0.614642
1181,13,15353,157400236,256059356,0.614702
1182,7,8274,157408510,256059356,0.614734
1183,11,13013,157421523,256059356,0.614785
1184,10,11840,157433363,256059356,0.614832
1185,8,9480,157442843,256059356,0.614869
1186,11,13046,157455889,256059356,0.614919
1187,6,7122,157463011,256059356,0.614947
1188,4,4752,157467763,256059356,0.614966
1189,10,11890,157479653,256059356,0.615012
1190,10,11900,157491553,256059356,0.615059
1191,14,16674,157508227,256059356,0.615124
1192,22,26224,157534451,256059356,0.615226
1193,6,7158,157541609,256059356,0.615254
1194,10,11940,157553549,256059356,0.615301
1195,6,7170,157560719,256059356,0.615329
1196,5,5980,157566699,256059356,0.615352
1197,4,4788,157571487,256059356,0.615371
1198,10,11980,157583467,256059356,0.615418
1199,9,10791,157594258,256059356,0.61546
1200,9,10800,157605058,256059356,0.615502
1201,8,9608,157614666,256059356,0.61554
1202,9,10818,157625484,256059356,0.615582
1203,7,8421,157633905,256059356,0.615615
1204,9,10836,157644741,256059356,0.615657
1205,6,7230,157651971,256059356,0.615685
1206,6,7236,157659207,256059356,0.615714
1207,5,6035,157665242,256059356,0.615737
1208,7,8456,157673698,256059356,0.61577
1209,12,14508,157688206,256059356,0.615827
1210,6,7260,157695466,256059356,0.615855
1211,7,8477,157703943,256059356,0.615888
1212,6,7272,157711215,256059356,0.615917
1213,4,4852,157716067,256059356,0.615936
1214,10,12140,157728207,256059356,0.615983
1215,7,8505,157736712,256059356,0.616016
1216,5,6080,157742792,256059356,0.61604
1217,10,12170,157754962,256059356,0.616087
1218,4,4872,157759834,256059356,0.616107
1219,13,15847,157775681,256059356,0.616168
1220,9,10980,157786661,256059356,0.616211
1221,13,15873,157802534,256059356,0.616273
1222,4,4888,157807422,256059356,0.616292
1223,8,9784,157817206,256059356,0.616331
1224,7,8568,157825774,256059356,0.616364
1225,7,8575,157834349,256059356,0.616398
1226,8,9808,157844157,256059356,0.616436
1227,6,7362,157851519,256059356,0.616465
1228,9,11052,157862571,256059356,0.616508
1229,12,14748,157877319,256059356,0.616565
1230,4,4920,157882239,256059356,0.616585
1231,8,9848,157892087,256059356,0.616623
1232,10,12320,157904407,256059356,0.616671
1233,9,11097,157915504,256059356,0.616714
1234,5,6170,157921674,256059356,0.616739
1235,14,17290,157938964,256059356,0.616806
1236,8,9888,157948852,256059356,0.616845
1237,9,11133,157959985,256059356,0.616888
1238,7,8666,157968651,256059356,0.616922
1239,5,6195,157974846,256059356,0.616946
1240,7,8680,157983526,256059356,0.61698
1241,8,9928,157993454,256059356,0.617019
1242,6,7452,158000906,256059356,0.617048
1243,4,4972,158005878,256059356,0.617067
1244,9,11196,158017074,256059356,0.617111
1245,8,9960,158027034,256059356,0.61715
1246,11,13706,158040740,256059356,0.617204
1247,5,6235,158046975,256059356,0.617228
1248,7,8736,158055711,256059356,0.617262
1249,6,7494,158063205,256059356,0.617291
1250,10,12500,158075705,256059356,0.61734
1251,7,8757,158084462,256059356,0.617374
1252,10,12520,158096982,256059356,0.617423
1253,7,8771,158105753,256059356,0.617457
1254,21,26334,158132087,256059356,0.61756
1255,8,10040,158142127,256059356,0.617599
1256,3,3768,158145895,256059356,0.617614
1257,5,6285,158152180,256059356,0.617639
1258,7,8806,158160986,256059356,0.617673
1259,8,10072,158171058,256059356,0.617712
1260,9,11340,158182398,256059356,0.617757
1261,5,6305,158188703,256059356,0.617781
1262,4,5048,158193751,256059356,0.617801
1263,7,8841,158202592,256059356,0.617836
1264,7,8848,158211440,256059356,0.61787
1265,11,13915,158225355,256059356,0.617925
1266,10,12660,158238015,256059356,0.617974
1267,10,12670,158250685,256059356,0.618023
1268,2,2536,158253221,256059356,0.618033
1269,4,5076,158258297,256059356,0.618053
1270,8,10160,158268457,256059356,0.618093
1271,8,10168,158278625,256059356,0.618133
1272,5,6360,158284985,256059356,0.618157
1273,9,11457,158296442,256059356,0.618202
1274,4,5096,158301538,256059356,0.618222
1275,10,12750,158314288,256059356,0.618272
1276,5,6380,158320668,256059356,0.618297
1277,12,15324,158335992,256059356,0.618357
1278,5,6390,158342382,256059356,0.618382
1279,12,15348,158357730,256059356,0.618441
1280,11,14080,158371810,256059356,0.618496
1281,7,8967,158380777,256059356,0.618531
1282,2,2564,158383341,256059356,0.618542
1283,9,11547,158394888,256059356,0.618587
1284,3,3852,158398740,256059356,0.618602
1285,7,8995,158407735,256059356,0.618637
1286,7,9002,158416737,256059356,0.618672
1287,4,5148,158421885,256059356,0.618692
1288,9,11592,158433477,256059356,0.618737
1289,6,7734,158441211,256059356,0.618768
1290,2,2580,158443791,256059356,0.618778
1291,4,5164,158448955,256059356,0.618798
1292,10,12920,158461875,256059356,0.618848
1293,7,9051,158470926,256059356,0.618884
1294,10,12940,158483866,256059356,0.618934
1295,7,9065,158492931,256059356,0.618969
1296,9,11664,158504595,256059356,0.619015
1297,9,11673,158516268,256059356,0.619061
1298,6,7788,158524056,256059356,0.619091
1299,5,6495,158530551,256059356,0.619116
1300,6,7800,158538351,256059356,0.619147
1301,4,5204,158543555,256059356,0.619167
1302,7,9114,158552669,256059356,0.619203
1303,6,7818,158560487,256059356,0.619233
1304,9,11736,158572223,256059356,0.619279
1305,6,7830,158580053,256059356,0.61931
1306,10,13060,158593113,256059356,0.619361
1307,11,14377,158607490,256059356,0.619417
1308,2,2616,158610106,256059356,0.619427
1309,6,7854,158617960,256059356,0.619458
1310,6,7860,158625820,256059356,0.619488
1311,1,1311,158627131,256059356,0.619494
1312,9,11808,158638939,256059356,0.61954
1313,9,11817,158650756,256059356,0.619586
1314,9,11826,158662582,256059356,0.619632
1315,7,9205,158671787,256059356,0.619668
1316,8,10528,158682315,256059356,0.619709
1317,4,5268,158687583,256059356,0.61973
1318,12,15816,158703399,256059356,0.619791
1319,5,6595,158709994,256059356,0.619817
1320,5,6600,158716594,256059356,0.619843
1321,8,10568,158727162,256059356,0.619884
1322,4,5288,158732450,256059356,0.619905
1323,5,6615,158739065,256059356,0.619931
1324,9,11916,158750981,256059356,0.619977
1325,9,11925,158762906,256059356,0.620024
1326,9,11934,158774840,256059356,0.62007
1327,7,9289,158784129,256059356,0.620107
1328,5,6640,158790769,256059356,0.620133
1329,10,13290,158804059,256059356,0.620185
1330,7,9310,158813369,256059356,0.620221
1331,7,9317,158822686,256059356,0.620257
1332,9,11988,158834674,256059356,0.620304
1333,6,7998,158842672,256059356,0.620335
1334,2,2668,158845340,256059356,0.620346
1335,10,13350,158858690,256059356,0.620398
1336,3,4008,158862698,256059356,0.620414
1337,3,4011,158866709,256059356,0.620429
1338,3,4014,158870723,256059356,0.620445
1339,5,6695,158877418,256059356,0.620471
1340,7,9380,158886798,256059356,0.620508
1341,3,4023,158890821,256059356,0.620523
1342,2,2684,158893505,256059356,0.620534
1343,6,8058,158901563,256059356,0.620565
1344,16,21504,158923067,256059356,0.620649
1345,5,6725,158929792,256059356,0.620676
1346,5,6730,158936522,256059356,0.620702
1347,7,9429,158945951,256059356,0.620739
1348,6,8088,158954039,256059356,0.62077
1349,19,25631,158979670,256059356,0.62087
1350,19,25650,159005320,256059356,0.620971
1351,6,8106,159013426,256059356,0.621002
1352,5,6760,159020186,256059356,0.621029
1353,3,4059,159024245,256059356,0.621044
1354,5,6770,159031015,256059356,0.621071
1355,4,5420,159036435,256059356,0.621092
1356,4,5424,159041859,256059356,0.621113
1357,8,10856,159052715,256059356,0.621156
1358,5,6790,159059505,256059356,0.621182
1359,9,12231,159071736,256059356,0.62123
1360,3,4080,159075816,256059356,0.621246
1361,7,9527,159085343,256059356,0.621283
1362,8,10896,159096239,256059356,0.621326
1363,4,5452,159101691,256059356,0.621347
1364,14,19096,159120787,256059356,0.621421
1365,7,9555,159130342,256059356,0.621459
1366,8,10928,159141270,256059356,0.621501
1367,7,9569,159150839,256059356,0.621539
1368,9,12312,159163151,256059356,0.621587
1369,9,12321,159175472,256059356,0.621635
1370,15,20550,159196022,256059356,0.621715
1371,3,4113,159200135,256059356,0.621731
1372,3,4116,159204251,256059356,0.621747
1373,7,9611,159213862,256059356,0.621785
1374,6,8244,159222106,256059356,0.621817
1375,8,11000,159233106,256059356,0.62186
1376,3,4128,159237234,256059356,0.621876
1377,7,9639,159246873,256059356,0.621914
1378,10,13780,159260653,256059356,0.621968
1379,2,2758,159263411,256059356,0.621978
1380,2,2760,159266171,256059356,0.621989
1381,4,5524,159271695,256059356,0.622011
1382,8,11056,159282751,256059356,0.622054
1383,3,4149,159286900,256059356,0.62207
1384,6,8304,159295204,256059356,0.622103
1385,3,4155,159299359,256059356,0.622119
1386,4,5544,159304903,256059356,0.622141
1387,7,9709,159314612,256059356,0.622178
1388,6,8328,159322940,256059356,0.622211
1389,10,13890,159336830,256059356,0.622265
1390,14,19460,159356290,256059356,0.622341
1391,8,11128,159367418,256059356,0.622385
1392,7,9744,159377162,256059356,0.622423
1393,9,12537,159389699,256059356,0.622472
1394,4,5576,159395275,256059356,0.622493
1395,4,5580,159400855,256059356,0.622515
1396,3,4188,159405043,256059356,0.622532
1397,8,11176,159416219,256059356,0.622575
1398,3,4194,159420413,256059356,0.622592
1399,8,11192,159431605,256059356,0.622635
1400,5,7000,159438605,256059356,0.622663
1401,3,4203,159442808,256059356,0.622679
1402,6,8412,159451220,256059356,0.622712
1403,4,5612,159456832,256059356,0.622734
1404,5,7020,159463852,256059356,0.622761
1405,9,12645,159476497,256059356,0.622811
1406,7,9842,159486339,256059356,0.622849
1407,3,4221,159490560,256059356,0.622866
1408,2,2816,159493376,256059356,0.622877
1409,5,7045,159500421,256059356,0.622904
1410,2,2820,159503241,256059356,0.622915
1411,4,5644,159508885,256059356,0.622937
1412,5,7060,159515945,256059356,0.622965
1413,3,4239,159520184,256059356,0.622981
1414,2,2828,159523012,256059356,0.622992
1415,7,9905,159532917,256059356,0.623031
1416,4,5664,159538581,256059356,0.623053
1417,5,7085,159545666,256059356,0.623081
1418,5,7090,159552756,256059356,0.623108
1419,7,9933,159562689,256059356,0.623147
1420,7,9940,159572629,256059356,0.623186
1421,5,7105,159579734,256059356,0.623214
1422,8,11376,159591110,256059356,0.623258
1423,5,7115,159598225,256059356,0.623286
1424,4,5696,159603921,256059356,0.623308
1425,2,2850,159606771,256059356,0.623319
1426,9,12834,159619605,256059356,0.62337
1427,8,11416,159631021,256059356,0.623414
1428,8,11424,159642445,256059356,0.623459
1429,2,2858,159645303,256059356,0.62347
1430,5,7150,159652453,256059356,0.623498
1431,6,8586,159661039,256059356,0.623531
1432,5,7160,159668199,256059356,0.623559
1433,3,4299,159672498,256059356,0.623576
1434,7,10038,159682536,256059356,0.623615
1435,5,7175,159689711,256059356,0.623643
1436,5,7180,159696891,256059356,0.623671
1437,6,8622,159705513,256059356,0.623705
1438,10,14380,159719893,256059356,0.623761
1439,7,10073,159729966,256059356,0.623801
1440,8,11520,159741486,256059356,0.623846
1441,5,7205,159748691,256059356,0.623874
1442,6,8652,159757343,256059356,0.623907
1443,7,10101,159767444,256059356,0.623947
1444,6,8664,159776108,256059356,0.623981
1445,7,10115,159786223,256059356,0.62402
1446,5,7230,159793453,256059356,0.624048
1447,9,13023,159806476,256059356,0.624099
1448,2,2896,159809372,256059356,0.624111
1449,5,7245,159816617,256059356,0.624139
1450,7,10150,159826767,256059356,0.624179
1451,7,10157,159836924,256059356,0.624218
1452,3,4356,159841280,256059356,0.624235
1453,10,14530,159855810,256059356,0.624292
1454,2,2908,159858718,256059356,0.624303
1455,4,5820,159864538,256059356,0.624326
1456,4,5824,159870362,256059356,0.624349
1457,3,4371,159874733,256059356,0.624366
1459,2,2918,159877651,256059356,0.624377
1460,5,7300,159884951,256059356,0.624406
1461,3,4383,159889334,256059356,0.624423
1462,2,2924,159892258,256059356,0.624434
1463,5,7315,159899573,256059356,0.624463
1464,6,8784,159908357,256059356,0.624497
1465,10,14650,159923007,256059356,0.624554
1466,9,13194,159936201,256059356,0.624606
1467,2,2934,159939135,256059356,0.624617
1468,23,33764,159972899,256059356,0.624749
1469,48,70512,160043411,256059356,0.625025
1470,3,4410,160047821,256059356,0.625042
1471,1,1471,160049292,256059356,0.625048
1472,8,11776,160061068,256059356,0.625094
1473,3,4419,160065487,256059356,0.625111
1474,6,8844,160074331,256059356,0.625145
1475,5,7375,160081706,256059356,0.625174
1476,5,7380,160089086,256059356,0.625203
1477,1,1477,160090563,256059356,0.625209
1478,10,14780,160105343,256059356,0.625267
1479,5,7395,160112738,256059356,0.625295
1480,6,8880,160121618,256059356,0.62533
1481,5,7405,160129023,256059356,0.625359
1482,6,8892,160137915,256059356,0.625394
1483,2,2966,160140881,256059356,0.625405
1484,4,5936,160146817,256059356,0.625428
1485,3,4455,160151272,256059356,0.625446
1486,2,2972,160154244,256059356,0.625457
1487,4,5948,160160192,256059356,0.625481
1488,5,7440,160167632,256059356,0.62551
1489,3,4467,160172099,256059356,0.625527
1490,3,4470,160176569,256059356,0.625545
1491,2,2982,160179551,256059356,0.625556
1492,2,2984,160182535,256059356,0.625568
1493,3,4479,160187014,256059356,0.625585
1494,3,4482,160191496,256059356,0.625603
1495,3,4485,160195981,256059356,0.62562
1496,6,8976,160204957,256059356,0.625656
1497,3,4491,160209448,256059356,0.625673
1498,3,4494,160213942,256059356,0.625691
1499,5,7495,160221437,256059356,0.62572
1500,5,7500,160228937,256059356,0.625749
1501,1,1501,160230438,256059356,0.625755
1502,2,3004,160233442,256059356,0.625767
1503,4,6012,160239454,256059356,0.62579
1504,5,7520,160246974,256059356,0.62582
1505,2,3010,160249984,256059356,0.625831
1506,4,6024,160256008,256059356,0.625855
1507,4,6028,160262036,256059356,0.625878
1508,3,4524,160266560,256059356,0.625896
1509,4,6036,160272596,256059356,0.62592
1510,3,4530,160277126,256059356,0.625937
1511,4,6044,160283170,256059356,0.625961
1512,3,4536,160287706,256059356,0.625979
1513,3,4539,160292245,256059356,0.625996
1514,3,4542,160296787,256059356,0.626014
1515,5,7575,160304362,256059356,0.626044
1516,8,12128,160316490,256059356,0.626091
1517,3,4551,160321041,256059356,0.626109
1518,1,1518,160322559,256059356,0.626115
1519,7,10633,160333192,256059356,0.626156
1520,5,7600,160340792,256059356,0.626186
1521,3,4563,160345355,256059356,0.626204
1522,6,9132,160354487,256059356,0.62624
1523,6,9138,160363625,256059356,0.626275
1524,2,3048,160366673,256059356,0.626287
1525,2,3050,160369723,256059356,0.626299
1526,4,6104,160375827,256059356,0.626323
1527,5,7635,160383462,256059356,0.626353
1528,3,4584,160388046,256059356,0.626371
1529,7,10703,160398749,256059356,0.626412
1530,2,3060,160401809,256059356,0.626424
1531,1,1531,160403340,256059356,0.62643
1532,1,1532,160404872,256059356,0.626436
1533,2,3066,160407938,256059356,0.626448
1534,1,1534,160409472,256059356,0.626454
1535,6,9210,160418682,256059356,0.62649
1536,1,1536,160420218,256059356,0.626496
1537,7,10759,160430977,256059356,0.626538
1538,5,7690,160438667,256059356,0.626568
1539,3,4617,160443284,256059356,0.626586
1540,1,1540,160444824,256059356,0.626592
1541,1,1541,160446365,256059356,0.626598
1542,1,1542,160447907,256059356,0.626604
1543,5,7715,160455622,256059356,0.626634
1545,3,4635,160460257,256059356,0.626653
1546,2,3092,160463349,256059356,0.626665
1547,3,4641,160467990,256059356,0.626683
1548,1,1548,160469538,256059356,0.626689
1549,3,4647,160474185,256059356,0.626707
1550,2,3100,160477285,256059356,0.626719
1551,4,6204,160483489,256059356,0.626743
1552,2,3104,160486593,256059356,0.626755
1553,6,9318,160495911,256059356,0.626792
1554,2,3108,160499019,256059356,0.626804
1555,5,7775,160506794,256059356,0.626834
1556,4,6224,160513018,256059356,0.626859
1557,2,3114,160516132,256059356,0.626871
1558,2,3116,160519248,256059356,0.626883
1560,2,3120,160522368,256059356,0.626895
1561,4,6244,160528612,256059356,0.62692
1562,2,3124,160531736,256059356,0.626932
1563,4,6252,160537988,256059356,0.626956
1564,6,9384,160547372,256059356,0.626993
1565,4,6260,160553632,256059356,0.627017
1566,4,6264,160559896,256059356,0.627042
1567,2,3134,160563030,256059356,0.627054
1568,6,9408,160572438,256059356,0.627091
1569,1,1569,160574007,256059356,0.627097
1570,4,6280,160580287,256059356,0.627121
1571,1,1571,160581858,256059356,0.627127
1572,1,1572,160583430,256059356,0.627134
1573,2,3146,160586576,256059356,0.627146
1574,5,7870,160594446,256059356,0.627177
1575,3,4725,160599171,256059356,0.627195
1576,4,6304,160605475,256059356,0.62722
1577,2,3154,160608629,256059356,0.627232
1578,2,3156,160611785,256059356,0.627244
1579,4,6316,160618101,256059356,0.627269
1580,5,7900,160626001,256059356,0.6273
1581,6,9486,160635487,256059356,0.627337
1582,4,6328,160641815,256059356,0.627362
1583,5,7915,160649730,256059356,0.627393
1584,2,3168,160652898,256059356,0.627405
1585,2,3170,160656068,256059356,0.627417
1586,4,6344,160662412,256059356,0.627442
1587,2,3174,160665586,256059356,0.627454
1588,4,6352,160671938,256059356,0.627479
1589,4,6356,160678294,256059356,0.627504
1590,5,7950,160686244,256059356,0.627535
1591,5,7955,160694199,256059356,0.627566
1592,2,3184,160697383,256059356,0.627579
1593,2,3186,160700569,256059356,0.627591
1594,1,1594,160702163,256059356,0.627597
1595,5,7975,160710138,256059356,0.627628
1596,2,3192,160713330,256059356,0.627641
1597,5,7985,160721315,256059356,0.627672
1598,1,1598,160722913,256059356,0.627678
1599,4,6396,160729309,256059356,0.627703
1600,2,3200,160732509,256059356,0.627716
1602,3,4806,160737315,256059356,0.627735
1603,5,8015,160745330,256059356,0.627766
1604,6,9624,160754954,256059356,0.627803
1605,3,4815,160759769,256059356,0.627822
1606,3,4818,160764587,256059356,0.627841
1607,2,3214,160767801,256059356,0.627854
1608,6,9648,160777449,256059356,0.627891
1609,4,6436,160783885,256059356,0.627916
1610,1,1610,160785495,256059356,0.627923
1611,2,3222,160788717,256059356,0.627935
1612,5,8060,160796777,256059356,0.627967
1613,3,4839,160801616,256059356,0.627986
1614,2,3228,160804844,256059356,0.627998
1615,5,8075,160812919,256059356,0.62803
1616,1,1616,160814535,256059356,0.628036
1617,5,8085,160822620,256059356,0.628068
1618,3,4854,160827474,256059356,0.628087
1619,3,4857,160832331,256059356,0.628106
1620,1,1620,160833951,256059356,0.628112
1621,3,4863,160838814,256059356,0.628131
1622,4,6488,160845302,256059356,0.628156
1623,2,3246,160848548,256059356,0.628169
1624,4,6496,160855044,256059356,0.628194
1625,5,8125,160863169,256059356,0.628226
1627,1,1627,160864796,256059356,0.628232
1628,3,4884,160869680,256059356,0.628252
1629,5,8145,160877825,256059356,0.628283
1630,4,6520,160884345,256059356,0.628309
1631,4,6524,160890869,256059356,0.628334
1632,9,14688,160905557,256059356,0.628392
1633,3,4899,160910456,256059356,0.628411
1634,4,6536,160916992,256059356,0.628436
1635,1,1635,160918627,256059356,0.628443
1636,4,6544,160925171,256059356,0.628468
1637,1,1637,160926808,256059356,0.628475
1638,3,4914,160931722,256059356,0.628494
1641,7,11487,160943209,256059356,0.628539
1642,3,4926,160948135,256059356,0.628558
1643,1,1643,160949778,256059356,0.628564
1644,2,3288,160953066,256059356,0.628577
1645,2,3290,160956356,256059356,0.62859
1646,3,4938,160961294,256059356,0.628609
1647,2,3294,160964588,256059356,0.628622
1648,1,1648,160966236,256059356,0.628629
1649,5,8245,160974481,256059356,0.628661
1650,5,8250,160982731,256059356,0.628693
1651,9,14859,160997590,256059356,0.628751
1652,3,4956,161002546,256059356,0.62877
1653,3,4959,161007505,256059356,0.62879
1655,4,6620,161014125,256059356,0.628816
1656,1,1656,161015781,256059356,0.628822
1657,4,6628,161022409,256059356,0.628848
1658,5,8290,161030699,256059356,0.62888
1659,2,3318,161034017,256059356,0.628893
1660,3,4980,161038997,256059356,0.628913
1661,6,9966,161048963,256059356,0.628952
1662,4,6648,161055611,256059356,0.628978
1663,2,3326,161058937,256059356,0.628991
1664,2,3328,161062265,256059356,0.629004
1665,4,6660,161068925,256059356,0.62903
1666,4,6664,161075589,256059356,0.629056
1667,5,8335,161083924,256059356,0.629088
1668,3,5004,161088928,256059356,0.629108
1669,5,8345,161097273,256059356,0.62914
1670,2,3340,161100613,256059356,0.629153
1671,5,8355,161108968,256059356,0.629186
1673,5,8365,161117333,256059356,0.629219
1674,2,3348,161120681,256059356,0.629232
1675,6,10050,161130731,256059356,0.629271
1676,4,6704,161137435,256059356,0.629297
1677,3,5031,161142466,256059356,0.629317
1678,5,8390,161150856,256059356,0.62935
1679,5,8395,161159251,256059356,0.629382
1680,4,6720,161165971,256059356,0.629409
1681,6,10086,161176057,256059356,0.629448
1682,2,3364,161179421,256059356,0.629461
1683,3,5049,161184470,256059356,0.629481
1684,1,1684,161186154,256059356,0.629487
1685,3,5055,161191209,256059356,0.629507
1686,3,5058,161196267,256059356,0.629527
1687,1,1687,161197954,256059356,0.629534
1688,3,5064,161203018,256059356,0.629553
1689,4,6756,161209774,256059356,0.62958
1690,6,10140,161219914,256059356,0.629619
1691,2,3382,161223296,256059356,0.629633
1692,3,5076,161228372,256059356,0.629652
1694,6,10164,161238536,256059356,0.629692
1695,1,1695,161240231,256059356,0.629699
1696,5,8480,161248711,256059356,0.629732
1697,4,6788,161255499,256059356,0.629758
1698,4,6792,161262291,256059356,0.629785
1700,3,5100,161267391,256059356,0.629805
1701,3,5103,161272494,256059356,0.629825
1702,4,6808,161279302,256059356,0.629851
1703,3,5109,161284411,256059356,0.629871
1704,4,6816,161291227,256059356,0.629898
1705,3,5115,161296342,256059356,0.629918
1706,3,5118,161301460,256059356,0.629938
1707,3,5121,161306581,256059356,0.629958
1708,2,3416,161309997,256059356,0.629971
1709,4,6836,161316833,256059356,0.629998
1710,3,5130,161321963,256059356,0.630018
1711,6,10266,161332229,256059356,0.630058
1712,3,5136,161337365,256059356,0.630078
1713,3,5139,161342504,256059356,0.630098
1714,3,5142,161347646,256059356,0.630118
1715,3,5145,161352791,256059356,0.630138
1716,1,1716,161354507,256059356,0.630145
1717,1,1717,161356224,256059356,0.630152
1719,2,3438,161359662,256059356,0.630165
1720,3,5160,161364822,256059356,0.630185
1721,2,3442,161368264,256059356,0.630199
1722,3,5166,161373430,256059356,0.630219
1723,6,10338,161383768,256059356,0.630259
1724,4,6896,161390664,256059356,0.630286
1725,2,3450,161394114,256059356,0.6303
1726,6,10356,161404470,256059356,0.63034
1727,1,1727,161406197,256059356,0.630347
1728,1,1728,161407925,256059356,0.630354
1729,2,3458,161411383,256059356,0.630367
1730,4,6920,161418303,256059356,0.630394
1731,3,5193,161423496,256059356,0.630414
1733,2,3466,161426962,256059356,0.630428
1735,1,1735,161428697,256059356,0.630435
1736,5,8680,161437377,256059356,0.630469
1737,4,6948,161444325,256059356,0.630496
1738,4,6952,161451277,256059356,0.630523
1739,4,6956,161458233,256059356,0.63055
1740,2,3480,161461713,256059356,0.630564
1741,1,1741,161463454,256059356,0.63057
1742,3,5226,161468680,256059356,0.630591
1743,2,3486,161472166,256059356,0.630604
1744,3,5232,161477398,256059356,0.630625
1745,2,3490,161480888,256059356,0.630638
1746,1,1746,161482634,256059356,0.630645
1748,6,10488,161493122,256059356,0.630686
1749,3,5247,161498369,256059356,0.630707
1750,3,5250,161503619,256059356,0.630727
1751,6,10506,161514125,256059356,0.630768
1752,4,7008,161521133,256059356,0.630796
1753,2,3506,161524639,256059356,0.630809
1755,6,10530,161535169,256059356,0.63085
1756,4,7024,161542193,256059356,0.630878
1757,1,1757,161543950,256059356,0.630885
1758,3,5274,161549224,256059356,0.630905
1759,1,1759,161550983,256059356,0.630912
1760,2,3520,161554503,256059356,0.630926
1761,2,3522,161558025,256059356,0.63094
1762,2,3524,161561549,256059356,0.630954
1763,1,1763,161563312,256059356,0.63096
1764,3,5292,161568604,256059356,0.630981
1765,3,5295,161573899,256059356,0.631002
1766,2,3532,161577431,256059356,0.631016
1768,4,7072,161584503,256059356,0.631043
1769,2,3538,161588041,256059356,0.631057
1770,3,5310,161593351,256059356,0.631078
1771,3,5313,161598664,256059356,0.631098
1772,3,5316,161603980,256059356,0.631119
1775,4,7100,161611080,256059356,0.631147
1776,2,3552,161614632,256059356,0.631161
1777,1,1777,161616409,256059356,0.631168
1778,2,3556,161619965,256059356,0.631182
1779,5,8895,161628860,256059356,0.631216
1780,2,3560,161632420,256059356,0.63123
1781,3,5343,161637763,256059356,0.631251
1782,6,10692,161648455,256059356,0.631293
1783,4,7132,161655587,256059356,0.631321
1784,3,5352,161660939,256059356,0.631342
1785,2,3570,161664509,256059356,0.631356
1786,2,3572,161668081,256059356,0.63137
1787,4,7148,161675229,256059356,0.631397
1788,1,1788,161677017,256059356,0.631404
1789,4,7156,161684173,256059356,0.631432
1790,4,7160,161691333,256059356,0.63146
1791,5,8955,161700288,256059356,0.631495
1792,5,8960,161709248,256059356,0.63153
1793,4,7172,161716420,256059356,0.631558
1794,5,8970,161725390,256059356,0.631593
1795,1,1795,161727185,256059356,0.6316
1796,1,1796,161728981,256059356,0.631607
1797,1,1797,161730778,256059356,0.631614
1798,6,10788,161741566,256059356,0.631657
1799,3,5397,161746963,256059356,0.631678
1800,3,5400,161752363,256059356,0.631699
1801,2,3602,161755965,256059356,0.631713
1802,3,5406,161761371,256059356,0.631734
1803,1,1803,161763174,256059356,0.631741
1804,5,9020,161772194,256059356,0.631776
1807,2,3614,161775808,256059356,0.63179
1808,3,5424,161781232,256059356,0.631811
1809,2,3618,161784850,256059356,0.631826
1810,5,9050,161793900,256059356,0.631861
1811,4,7244,161801144,256059356,0.631889
1812,5,9060,161810204,256059356,0.631925
1813,4,7252,161817456,256059356,0.631953
1814,3,5442,161822898,256059356,0.631974
1815,4,7260,161830158,256059356,0.632003
1816,5,9080,161839238,256059356,0.632038
1817,1,1817,161841055,256059356,0.632045
1818,6,10908,161851963,256059356,0.632088
1819,4,7276,161859239,256059356,0.632116
1820,4,7280,161866519,256059356,0.632145
1821,2,3642,161870161,256059356,0.632159
1822,7,12754,161882915,256059356,0.632209
1823,2,3646,161886561,256059356,0.632223
1824,3,5472,161892033,256059356,0.632244
1825,3,5475,161897508,256059356,0.632266
1826,2,3652,161901160,256059356,0.63228
1828,3,5484,161906644,256059356,0.632301
1829,4,7316,161913960,256059356,0.63233
1830,1,1830,161915790,256059356,0.632337
1831,1,1831,161917621,256059356,0.632344
1832,4,7328,161924949,256059356,0.632373
1833,7,12831,161937780,256059356,0.632423
1834,3,5502,161943282,256059356,0.632444
1835,2,3670,161946952,256059356,0.632459
1836,1,1836,161948788,256059356,0.632466
1837,1,1837,161950625,256059356,0.632473
1838,6,11028,161961653,256059356,0.632516
1840,4,7360,161969013,256059356,0.632545
1841,6,11046,161980059,256059356,0.632588
1842,2,3684,161983743,256059356,0.632602
1843,4,7372,161991115,256059356,0.632631
1844,3,5532,161996647,256059356,0.632653
1846,1,1846,161998493,256059356,0.63266
1847,1,1847,162000340,256059356,0.632667
1848,3,5544,162005884,256059356,0.632689
1849,6,11094,162016978,256059356,0.632732
1850,4,7400,162024378,256059356,0.632761
1851,3,5553,162029931,256059356,0.632783
1852,3,5556,162035487,256059356,0.632804
1853,3,5559,162041046,256059356,0.632826
1854,1,1854,162042900,256059356,0.632833
1855,9,16695,162059595,256059356,0.632899
1856,3,5568,162065163,256059356,0.63292
1857,2,3714,162068877,256059356,0.632935
1859,1,1859,162070736,256059356,0.632942
1860,1,1860,162072596,256059356,0.632949
1861,2,3722,162076318,256059356,0.632964
1862,2,3724,162080042,256059356,0.632978
1863,6,11178,162091220,256059356,0.633022
1864,4,7456,162098676,256059356,0.633051
1865,3,5595,162104271,256059356,0.633073
1866,1,1866,162106137,256059356,0.63308
1867,5,9335,162115472,256059356,0.633117
1868,7,13076,162128548,256059356,0.633168
1869,3,5607,162134155,256059356,0.63319
1870,5,9350,162143505,256059356,0.633226
1871,1,1871,162145376,256059356,0.633234
1873,2,3746,162149122,256059356,0.633248
1874,2,3748,162152870,256059356,0.633263
1875,2,3750,162156620,256059356,0.633277
1876,4,7504,162164124,256059356,0.633307
1877,2,3754,162167878,256059356,0.633321
1878,2,3756,162171634,256059356,0.633336
1879,1,1879,162173513,256059356,0.633343
1880,2,3760,162177273,256059356,0.633358
1881,1,1881,162179154,256059356,0.633365
1882,2,3764,162182918,256059356,0.63338
1883,1,1883,162184801,256059356,0.633388
1885,2,3770,162188571,256059356,0.633402
1886,3,5658,162194229,256059356,0.633424
1887,2,3774,162198003,256059356,0.633439
1888,2,3776,162201779,256059356,0.633454
1891,2,3782,162205561,256059356,0.633469
1892,2,3784,162209345,256059356,0.633483
1893,4,7572,162216917,256059356,0.633513
1894,4,7576,162224493,256059356,0.633543
1895,2,3790,162228283,256059356,0.633557
1896,2,3792,162232075,256059356,0.633572
1897,3,5691,162237766,256059356,0.633594
1898,1,1898,162239664,256059356,0.633602
1899,1,1899,162241563,256059356,0.633609
1900,3,5700,162247263,256059356,0.633631
1901,1,1901,162249164,256059356,0.633639
1902,2,3804,162252968,256059356,0.633654
1904,5,9520,162262488,256059356,0.633691
1905,3,5715,162268203,256059356,0.633713
1906,4,7624,162275827,256059356,0.633743
1907,3,5721,162281548,256059356,0.633765
1908,2,3816,162285364,256059356,0.63378
1909,2,3818,162289182,256059356,0.633795
1911,2,3822,162293004,256059356,0.63381
1913,3,5739,162298743,256059356,0.633833
1914,1,1914,162300657,256059356,0.63384
1915,3,5745,162306402,256059356,0.633862
1916,3,5748,162312150,256059356,0.633885
1917,4,7668,162319818,256059356,0.633915
1918,1,1918,162321736,256059356,0.633922
1919,2,3838,162325574,256059356,0.633937
1920,1,1920,162327494,256059356,0.633945
1921,2,3842,162331336,256059356,0.63396
1922,6,11532,162342868,256059356,0.634005
1923,2,3846,162346714,256059356,0.63402
1924,2,3848,162350562,256059356,0.634035
1925,2,3850,162354412,256059356,0.63405
1926,1,1926,162356338,256059356,0.634057
1927,3,5781,162362119,256059356,0.63408
1928,1,1928,162364047,256059356,0.634088
1929,4,7716,162371763,256059356,0.634118
1930,1,1930,162373693,256059356,0.634125
1932,6,11592,162385285,256059356,0.63417
1933,1,1933,162387218,256059356,0.634178
1934,1,1934,162389152,256059356,0.634186
1935,4,7740,162396892,256059356,0.634216
1936,3,5808,162402700,256059356,0.634238
1937,4,7748,162410448,256059356,0.634269
1938,1,1938,162412386,256059356,0.634276
1939,2,3878,162416264,256059356,0.634291
1940,3,5820,162422084,256059356,0.634314
1941,3,5823,162427907,256059356,0.634337
1942,2,3884,162431791,256059356,0.634352
1943,3,5829,162437620,256059356,0.634375
1944,1,1944,162439564,256059356,0.634382
1945,2,3890,162443454,256059356,0.634398
1946,1,1946,162445400,256059356,0.634405
1948,1,1948,162447348,256059356,0.634413
1949,2,3898,162451246,256059356,0.634428
1950,2,3900,162455146,256059356,0.634443
1951,1,1951,162457097,256059356,0.634451
1952,3,5856,162462953,256059356,0.634474
1953,2,3906,162466859,256059356,0.634489
1954,2,3908,162470767,256059356,0.634504
1956,4,7824,162478591,256059356,0.634535
1957,2,3914,162482505,256059356,0.63455
1958,1,1958,162484463,256059356,0.634558
1959,1,1959,162486422,256059356,0.634565
1961,3,5883,162492305,256059356,0.634588
1962,1,1962,162494267,256059356,0.634596
1963,2,3926,162498193,256059356,0.634611
1964,3,5892,162504085,256059356,0.634634
1965,2,3930,162508015,256059356,0.63465
1967,3,5901,162513916,256059356,0.634673
1968,3,5904,162519820,256059356,0.634696
1970,1,1970,162521790,256059356,0.634704
1971,1,1971,162523761,256059356,0.634711
1972,4,7888,162531649,256059356,0.634742
1973,2,3946,162535595,256059356,0.634757
1974,1,1974,162537569,256059356,0.634765
1975,5,9875,162547444,256059356,0.634804
1976,5,9880,162557324,256059356,0.634842
1977,5,9885,162567209,256059356,0.634881
1978,5,9890,162577099,256059356,0.63492
1979,1,1979,162579078,256059356,0.634927
1980,1,1980,162581058,256059356,0.634935
1981,4,7924,162588982,256059356,0.634966
1982,1,1982,162590964,256059356,0.634974
1983,3,5949,162596913,256059356,0.634997
1984,5,9920,162606833,256059356,0.635036
1985,1,1985,162608818,256059356,0.635043
1986,4,7944,162616762,256059356,0.635074
1989,1,1989,162618751,256059356,0.635082
1990,1,1990,162620741,256059356,0.63509
1991,3,5973,162626714,256059356,0.635113
1993,4,7972,162634686,256059356,0.635144
1994,1,1994,162636680,256059356,0.635152
1995,3,5985,162642665,256059356,0.635176
1997,3,5991,162648656,256059356,0.635199
1998,1,1998,162650654,256059356,0.635207
1999,1,1999,162652653,256059356,0.635215
2000,8,16000,162668653,256059356,0.635277
2001,2,4002,162672655,256059356,0.635293
2002,2,4004,162676659,256059356,0.635308
2003,1,2003,162678662,256059356,0.635316
2004,5,10020,162688682,256059356,0.635355
2005,1,2005,162690687,256059356,0.635363
2006,1,2006,162692693,256059356,0.635371
2007,2,4014,162696707,256059356,0.635387
2008,4,8032,162704739,256059356,0.635418
2009,1,2009,162706748,256059356,0.635426
2010,4,8040,162714788,256059356,0.635457
2011,3,6033,162720821,256059356,0.635481
2012,2,4024,162724845,256059356,0.635497
2013,2,4026,162728871,256059356,0.635512
2014,1,2014,162730885,256059356,0.63552
2015,1,2015,162732900,256059356,0.635528
2016,7,14112,162747012,256059356,0.635583
2017,3,6051,162753063,256059356,0.635607
2018,1,2018,162755081,256059356,0.635615
2019,2,4038,162759119,256059356,0.63563
2020,2,4040,162763159,256059356,0.635646
2021,1,2021,162765180,256059356,0.635654
2022,3,6066,162771246,256059356,0.635678
2023,4,8092,162779338,256059356,0.635709
2024,3,6072,162785410,256059356,0.635733
2025,4,8100,162793510,256059356,0.635765
2026,4,8104,162801614,256059356,0.635796
2028,3,6084,162807698,256059356,0.63582
2029,2,4058,162811756,256059356,0.635836
2030,1,2030,162813786,256059356,0.635844
2031,3,6093,162819879,256059356,0.635868
2032,1,2032,162821911,256059356,0.635876
2033,3,6099,162828010,256059356,0.635899
2034,3,6102,162834112,256059356,0.635923
2035,3,6105,162840217,256059356,0.635947
2037,3,6111,162846328,256059356,0.635971
2038,3,6114,162852442,256059356,0.635995
2039,2,4078,162856520,256059356,0.636011
2040,4,8160,162864680,256059356,0.636043
2041,2,4082,162868762,256059356,0.636059
2042,2,4084,162872846,256059356,0.636075
2043,5,10215,162883061,256059356,0.636114
2044,2,4088,162887149,256059356,0.63613
2045,2,4090,162891239,256059356,0.636146
2046,3,6138,162897377,256059356,0.63617
2048,2,4096,162901473,256059356,0.636186
2049,3,6147,162907620,256059356,0.63621
2050,2,4100,162911720,256059356,0.636226
2051,4,8204,162919924,256059356,0.636258
2052,1,2052,162921976,256059356,0.636266
2053,3,6159,162928135,256059356,0.63629
2054,1,2054,162930189,256059356,0.636299
2055,2,4110,162934299,256059356,0.636315
2056,3,6168,162940467,256059356,0.636339
2057,2,4114,162944581,256059356,0.636355
2059,3,6177,162950758,256059356,0.636379
2060,2,4120,162954878,256059356,0.636395
2061,3,6183,162961061,256059356,0.636419
2062,3,6186,162967247,256059356,0.636443
2063,3,6189,162973436,256059356,0.636467
2064,3,6192,162979628,256059356,0.636492
2065,1,2065,162981693,256059356,0.6365
2066,2,4132,162985825,256059356,0.636516
2067,2,4134,162989959,256059356,0.636532
2068,4,8272,162998231,256059356,0.636564
2069,1,2069,163000300,256059356,0.636572
2070,2,4140,163004440,256059356,0.636588
2071,1,2071,163006511,256059356,0.636597
2072,2,4144,163010655,256059356,0.636613
2073,3,6219,163016874,256059356,0.636637
2074,2,4148,163021022,256059356,0.636653
2075,2,4150,163025172,256059356,0.636669
2078,2,4156,163029328,256059356,0.636686
2079,1,2079,163031407,256059356,0.636694
2080,2,4160,163035567,256059356,0.63671
2081,2,4162,163039729,256059356,0.636726
2082,3,6246,163045975,256059356,0.636751
2085,1,2085,163048060,256059356,0.636759
2086,3,6258,163054318,256059356,0.636783
2087,2,4174,163058492,256059356,0.6368
2088,1,2088,163060580,256059356,0.636808
2089,1,2089,163062669,256059356,0.636816
2090,3,6270,163068939,256059356,0.63684
2091,1,2091,163071030,256059356,0.636849
2093,1,2093,163073123,256059356,0.636857
2094,3,6282,163079405,256059356,0.636881
2095,4,8380,163087785,256059356,0.636914
2096,4,8384,163096169,256059356,0.636947
2098,4,8392,163104561,256059356,0.63698
2099,9,18891,163123452,256059356,0.637053
2100,2,4200,163127652,256059356,0.63707
2101,3,6303,163133955,256059356,0.637094
2102,1,2102,163136057,256059356,0.637103
2104,1,2104,163138161,256059356,0.637111
2105,5,10525,163148686,256059356,0.637152
2106,1,2106,163150792,256059356,0.63716
2107,3,6321,163157113,256059356,0.637185
2108,2,4216,163161329,256059356,0.637201
2109,1,2109,163163438,256059356,0.637209
2111,4,8444,163171882,256059356,0.637242
2112,1,2112,163173994,256059356,0.637251
2113,2,4226,163178220,256059356,0.637267
2114,11,23254,163201474,256059356,0.637358
2115,1,2115,163203589,256059356,0.637366
2116,3,6348,163209937,256059356,0.637391
2117,1,2117,163212054,256059356,0.637399
2118,4,8472,163220526,256059356,0.637432
2119,1,2119,163222645,256059356,0.637441
2120,1,2120,163224765,256059356,0.637449
2121,1,2121,163226886,256059356,0.637457
2123,3,6369,163233255,256059356,0.637482
2124,1,2124,163235379,256059356,0.63749
2126,3,6378,163241757,256059356,0.637515
2127,1,2127,163243884,256059356,0.637524
2128,3,6384,163250268,256059356,0.637549
2130,4,8520,163258788,256059356,0.637582
2131,1,2131,163260919,256059356,0.63759
2132,2,4264,163265183,256059356,0.637607
2133,2,4266,163269449,256059356,0.637623
2134,1,2134,163271583,256059356,0.637632
2137,3,6411,163277994,256059356,0.637657
2138,2,4276,163282270,256059356,0.637674
2139,3,6417,163288687,256059356,0.637699
2140,1,2140,163290827,256059356,0.637707
2141,3,6423,163297250,256059356,0.637732
2142,2,4284,163301534,256059356,0.637749
2144,2,4288,163305822,256059356,0.637765
2145,4,8580,163314402,256059356,0.637799
2146,1,2146,163316548,256059356,0.637807
2147,2,4294,163320842,256059356,0.637824
2148,3,6444,163327286,256059356,0.637849
2149,1,2149,163329435,256059356,0.637858
2150,3,6450,163335885,256059356,0.637883
2151,1,2151,163338036,256059356,0.637891
2152,5,10760,163348796,256059356,0.637933
2153,3,6459,163355255,256059356,0.637959
2155,5,10775,163366030,256059356,0.638001
2156,1,2156,163368186,256059356,0.638009
2157,3,6471,163374657,256059356,0.638034
2158,6,12948,163387605,256059356,0.638085
2161,1,2161,163389766,256059356,0.638093
2162,1,2162,163391928,256059356,0.638102
2163,3,6489,163398417,256059356,0.638127
2165,2,4330,163402747,256059356,0.638144
2166,2,4332,163407079,256059356,0.638161
2167,2,4334,163411413,256059356,0.638178
2168,6,13008,163424421,256059356,0.638229
2169,2,4338,163428759,256059356,0.638246
2170,5,10850,163439609,256059356,0.638288
2172,3,6516,163446125,256059356,0.638313
2174,4,8696,163454821,256059356,0.638347
2175,7,15225,163470046,256059356,0.638407
2176,6,13056,163483102,256059356,0.638458
2177,5,10885,163493987,256059356,0.6385
2178,2,4356,163498343,256059356,0.638517
2179,2,4358,163502701,256059356,0.638534
2180,1,2180,163504881,256059356,0.638543
2181,1,2181,163507062,256059356,0.638551
2182,2,4364,163511426,256059356,0.638568
2183,3,6549,163517975,256059356,0.638594
2184,1,2184,163520159,256059356,0.638603
2185,5,10925,163531084,256059356,0.638645
2186,2,4372,163535456,256059356,0.638662
2187,1,2187,163537643,256059356,0.638671
2188,2,4376,163542019,256059356,0.638688
2189,1,2189,163544208,256059356,0.638696
2190,2,4380,163548588,256059356,0.638714
2191,3,6573,163555161,256059356,0.638739
2192,5,10960,163566121,256059356,0.638782
2193,7,15351,163581472,256059356,0.638842
2194,3,6582,163588054,256059356,0.638868
2195,2,4390,163592444,256059356,0.638885
2196,1,2196,163594640,256059356,0.638893
2199,1,2199,163596839,256059356,0.638902
2200,3,6600,163603439,256059356,0.638928
2201,2,4402,163607841,256059356,0.638945
2202,6,13212,163621053,256059356,0.638997
2203,3,6609,163627662,256059356,0.639022
2204,4,8816,163636478,256059356,0.639057
2205,1,2205,163638683,256059356,0.639065
2206,3,6618,163645301,256059356,0.639091
2208,3,6624,163651925,256059356,0.639117
2209,2,4418,163656343,256059356,0.639134
2210,2,4420,163660763,256059356,0.639152
2211,4,8844,163669607,256059356,0.639186
2212,2,4424,163674031,256059356,0.639203
2213,1,2213,163676244,256059356,0.639212
2214,4,8856,163685100,256059356,0.639247
2215,1,2215,163687315,256059356,0.639255
2216,1,2216,163689531,256059356,0.639264
2217,2,4434,163693965,256059356,0.639281
2219,2,4438,163698403,256059356,0.639299
2220,1,2220,163700623,256059356,0.639307
2221,1,2221,163702844,256059356,0.639316
2222,2,4444,163707288,256059356,0.639333
2223,2,4446,163711734,256059356,0.639351
2224,2,4448,163716182,256059356,0.639368
2225,3,6675,163722857,256059356,0.639394
2226,2,4452,163727309,256059356,0.639412
2227,2,4454,163731763,256059356,0.639429
2228,1,2228,163733991,256059356,0.639438
2232,2,4464,163738455,256059356,0.639455
2233,5,11165,163749620,256059356,0.639499
2234,3,6702,163756322,256059356,0.639525
2235,2,4470,163760792,256059356,0.639542
2236,2,4472,163765264,256059356,0.63956
2237,3,6711,163771975,256059356,0.639586
2238,3,6714,163778689,256059356,0.639612
2239,4,8956,163787645,256059356,0.639647
2240,2,4480,163792125,256059356,0.639665
2241,1,2241,163794366,256059356,0.639673
2242,3,6726,163801092,256059356,0.6397
2243,5,11215,163812307,256059356,0.639743
2244,5,11220,163823527,256059356,0.639787
2245,3,6735,163830262,256059356,0.639814
2246,1,2246,163832508,256059356,0.639822
2247,3,6741,163839249,256059356,0.639849
2248,1,2248,163841497,256059356,0.639857
2249,3,6747,163848244,256059356,0.639884
2251,1,2251,163850495,256059356,0.639893
2252,3,6756,163857251,256059356,0.639919
2253,1,2253,163859504,256059356,0.639928
2254,1,2254,163861758,256059356,0.639937
2255,2,4510,163866268,256059356,0.639954
2256,1,2256,163868524,256059356,0.639963
2257,3,6771,163875295,256059356,0.639989
2259,4,9036,163884331,256059356,0.640025
2260,1,2260,163886591,256059356,0.640034
2261,1,2261,163888852,256059356,0.640042
2262,1,2262,163891114,256059356,0.640051
2263,1,2263,163893377,256059356,0.64006
2264,2,4528,163897905,256059356,0.640078
2265,1,2265,163900170,256059356,0.640087
2266,2,4532,163904702,256059356,0.640104
2267,1,2267,163906969,256059356,0.640113
2268,3,6804,163913773,256059356,0.64014
2269,2,4538,163918311,256059356,0.640157
2270,2,4540,163922851,256059356,0.640175
2271,3,6813,163929664,256059356,0.640202
2272,3,6816,163936480,256059356,0.640228
2274,3,6822,163943302,256059356,0.640255
2276,2,4552,163947854,256059356,0.640273
2277,3,6831,163954685,256059356,0.6403
2279,4,9116,163963801,256059356,0.640335
2280,1,2280,163966081,256059356,0.640344
2281,3,6843,163972924,256059356,0.640371
2283,2,4566,163977490,256059356,0.640389
2284,2,4568,163982058,256059356,0.640406
2285,3,6855,163988913,256059356,0.640433
2286,1,2286,163991199,256059356,0.640442
2289,2,4578,163995777,256059356,0.64046
2290,1,2290,163998067,256059356,0.640469
2291,5,11455,164009522,256059356,0.640514
2292,1,2292,164011814,256059356,0.640523
2293,2,4586,164016400,256059356,0.640541
2294,1,2294,164018694,256059356,0.64055
2295,1,2295,164020989,256059356,0.640558
2296,2,4592,164025581,256059356,0.640576
2297,2,4594,164030175,256059356,0.640594
2298,2,4596,164034771,256059356,0.640612
2299,1,2299,164037070,256059356,0.640621
2300,2,4600,164041670,256059356,0.640639
2302,5,11510,164053180,256059356,0.640684
2303,1,2303,164055483,256059356,0.640693
2304,3,6912,164062395,256059356,0.64072
2305,2,4610,164067005,256059356,0.640738
2306,2,4612,164071617,256059356,0.640756
2307,3,6921,164078538,256059356,0.640783
2308,3,6924,164085462,256059356,0.64081
2310,3,6930,164092392,256059356,0.640837
2311,2,4622,164097014,256059356,0.640855
2312,1,2312,164099326,256059356,0.640864
2313,1,2313,164101639,256059356,0.640873
2314,2,4628,164106267,256059356,0.640892
2315,3,6945,164113212,256059356,0.640919
2316,2,4632,164117844,256059356,0.640937
2317,1,2317,164120161,256059356,0.640946
2318,2,4636,164124797,256059356,0.640964
2319,1,2319,164127116,256059356,0.640973
2320,2,4640,164131756,256059356,0.640991
2321,2,4642,164136398,256059356,0.641009
2322,3,6966,164143364,256059356,0.641036
2323,3,6969,164150333,256059356,0.641064
2324,1,2324,164152657,256059356,0.641073
2325,1,2325,164154982,256059356,0.641082
2326,2,4652,164159634,256059356,0.6411
2328,2,4656,164164290,256059356,0.641118
2330,2,4660,164168950,256059356,0.641136
2331,2,4662,164173612,256059356,0.641155
2332,1,2332,164175944,256059356,0.641164
2333,3,6999,164182943,256059356,0.641191
2334,1,2334,164185277,256059356,0.6412
2335,5,11675,164196952,256059356,0.641246
2336,1,2336,164199288,256059356,0.641255
2337,2,4674,164203962,256059356,0.641273
2338,2,4676,164208638,256059356,0.641291
2339,1,2339,164210977,256059356,0.6413
2340,1,2340,164213317,256059356,0.64131
2342,2,4684,164218001,256059356,0.641328
2343,1,2343,164220344,256059356,0.641337
2346,2,4692,164225036,256059356,0.641355
2347,1,2347,164227383,256059356,0.641365
2348,2,4696,164232079,256059356,0.641383
2349,2,4698,164236777,256059356,0.641401
2350,2,4700,164241477,256059356,0.64142
2351,1,2351,164243828,256059356,0.641429
2352,1,2352,164246180,256059356,0.641438
2353,3,7059,164253239,256059356,0.641465
2354,1,2354,164255593,256059356,0.641475
2355,3,7065,164262658,256059356,0.641502
2356,2,4712,164267370,256059356,0.641521
2357,1,2357,164269727,256059356,0.64153
2358,2,4716,164274443,256059356,0.641548
2359,2,4718,164279161,256059356,0.641567
2360,6,14160,164293321,256059356,0.641622
2361,1,2361,164295682,256059356,0.641631
2362,1,2362,164298044,256059356,0.64164
2363,4,9452,164307496,256059356,0.641677
2365,4,9460,164316956,256059356,0.641714
2366,4,9464,164326420,256059356,0.641751
2367,2,4734,164331154,256059356,0.64177
2368,2,4736,164335890,256059356,0.641788
2370,2,4740,164340630,256059356,0.641807
2371,2,4742,164345372,256059356,0.641825
2373,3,7119,164352491,256059356,0.641853
2375,3,7125,164359616,256059356,0.641881
2376,1,2376,164361992,256059356,0.64189
2377,2,4754,164366746,256059356,0.641909
2378,1,2378,164369124,256059356,0.641918
2380,3,7140,164376264,256059356,0.641946
2382,1,2382,164378646,256059356,0.641955
2383,1,2383,164381029,256059356,0.641965
2384,1,2384,164383413,256059356,0.641974
2385,3,7155,164390568,256059356,0.642002
2386,1,2386,164392954,256059356,0.642011
2387,1,2387,164395341,256059356,0.64202
2389,1,2389,164397730,256059356,0.64203
2390,2,4780,164402510,256059356,0.642048
2391,2,4782,164407292,256059356,0.642067
2392,5,11960,164419252,256059356,0.642114
2394,3,7182,164426434,256059356,0.642142
2395,2,4790,164431224,256059356,0.642161
2396,3,7188,164438412,256059356,0.642189
2397,2,4794,164443206,256059356,0.642207
2398,4,9592,164452798,256059356,0.642245
2399,3,7197,164459995,256059356,0.642273
2400,1,2400,164462395,256059356,0.642282
2401,2,4802,164467197,256059356,0.642301
2402,3,7206,164474403,256059356,0.642329
2403,1,2403,164476806,256059356,0.642339
2404,1,2404,164479210,256059356,0.642348
2405,2,4810,164484020,256059356,0.642367
2406,6,14436,164498456,256059356,0.642423
2407,3,7221,164505677,256059356,0.642451
2408,3,7224,164512901,256059356,0.64248
2409,2,4818,164517719,256059356,0.642498
2410,4,9640,164527359,256059356,0.642536
2412,3,7236,164534595,256059356,0.642564
2413,3,7239,164541834,256059356,0.642593
2414,2,4828,164546662,256059356,0.642611
2415,4,9660,164556322,256059356,0.642649
2416,3,7248,164563570,256059356,0.642677
2417,2,4834,164568404,256059356,0.642696
2418,1,2418,164570822,256059356,0.642706
2419,2,4838,164575660,256059356,0.642725
2420,2,4840,164580500,256059356,0.642744
2421,4,9684,164590184,256059356,0.642781
2422,8,19376,164609560,256059356,0.642857
2423,3,7269,164616829,256059356,0.642885
2424,3,7272,164624101,256059356,0.642914
2425,3,7275,164631376,256059356,0.642942
2426,2,4852,164636228,256059356,0.642961
2427,1,2427,164638655,256059356,0.642971
2428,2,4856,164643511,256059356,0.64299
2429,3,7287,164650798,256059356,0.643018
2430,2,4860,164655658,256059356,0.643037
2431,1,2431,164658089,256059356,0.643047
2432,3,7296,164665385,256059356,0.643075
2434,4,9736,164675121,256059356,0.643113
2435,1,2435,164677556,256059356,0.643123
2436,1,2436,164679992,256059356,0.643132
2437,3,7311,164687303,256059356,0.643161
2438,2,4876,164692179,256059356,0.64318
2439,1,2439,164694618,256059356,0.643189
2441,2,4882,164699500,256059356,0.643208
2442,1,2442,164701942,256059356,0.643218
2443,1,2443,164704385,256059356,0.643227
2444,3,7332,164711717,256059356,0.643256
2445,3,7335,164719052,256059356,0.643285
2447,2,4894,164723946,256059356,0.643304
2448,2,4896,164728842,256059356,0.643323
2449,4,9796,164738638,256059356,0.643361
2450,5,12250,164750888,256059356,0.643409
2451,3,7353,164758241,256059356,0.643438
2452,2,4904,164763145,256059356,0.643457
2453,6,14718,164777863,256059356,0.643514
2454,3,7362,164785225,256059356,0.643543
2455,1,2455,164787680,256059356,0.643553
2456,3,7368,164795048,256059356,0.643581
2457,1,2457,164797505,256059356,0.643591
2458,2,4916,164802421,256059356,0.64361
2459,2,4918,164807339,256059356,0.643629
2462,2,4924,164812263,256059356,0.643649
2463,3,7389,164819652,256059356,0.643678
2465,5,12325,164831977,256059356,0.643726
2466,3,7398,164839375,256059356,0.643755
2467,1,2467,164841842,256059356,0.643764
2468,6,14808,164856650,256059356,0.643822
2469,4,9876,164866526,256059356,0.643861
2470,3,7410,164873936,256059356,0.64389
2471,4,9884,164883820,256059356,0.643928
2472,2,4944,164888764,256059356,0.643947
2473,2,4946,164893710,256059356,0.643967
2474,2,4948,164898658,256059356,0.643986
2475,2,4950,164903608,256059356,0.644005
2476,1,2476,164906084,256059356,0.644015
2477,1,2477,164908561,256059356,0.644025
2478,2,4956,164913517,256059356,0.644044
2480,2,4960,164918477,256059356,0.644063
2481,4,9924,164928401,256059356,0.644102
2483,1,2483,164930884,256059356,0.644112
2484,1,2484,164933368,256059356,0.644122
2485,2,4970,164938338,256059356,0.644141
2486,3,7458,164945796,256059356,0.64417
2487,2,4974,164950770,256059356,0.64419
2488,1,2488,164953258,256059356,0.644199
2489,2,4978,164958236,256059356,0.644219
2490,1,2490,164960726,256059356,0.644228
2491,1,2491,164963217,256059356,0.644238
2492,4,9968,164973185,256059356,0.644277
2493,1,2493,164975678,256059356,0.644287
2494,2,4988,164980666,256059356,0.644306
2495,2,4990,164985656,256059356,0.644326
2496,1,2496,164988152,256059356,0.644336
2497,1,2497,164990649,256059356,0.644345
2498,1,2498,164993147,256059356,0.644355
2499,3,7497,165000644,256059356,0.644384
2500,4,10000,165010644,256059356,0.644423
2501,1,2501,165013145,256059356,0.644433
2503,3,7509,165020654,256059356,0.644463
2504,2,5008,165025662,256059356,0.644482
2505,2,5010,165030672,256059356,0.644502
2506,4,10024,165040696,256059356,0.644541
2508,1,2508,165043204,256059356,0.644551
2509,1,2509,165045713,256059356,0.64456
2510,4,10040,165055753,256059356,0.6446
2511,1,2511,165058264,256059356,0.644609
2512,4,10048,165068312,256059356,0.644649
2514,1,2514,165070826,256059356,0.644658
2515,3,7545,165078371,256059356,0.644688
2518,3,7554,165085925,256059356,0.644717
2519,2,5038,165090963,256059356,0.644737
2520,2,5040,165096003,256059356,0.644757
2521,2,5042,165101045,256059356,0.644776
2522,2,5044,165106089,256059356,0.644796
2523,1,2523,165108612,256059356,0.644806
2524,3,7572,165116184,256059356,0.644836
2525,1,2525,165118709,256059356,0.644845
2526,2,5052,165123761,256059356,0.644865
2527,3,7581,165131342,256059356,0.644895
2528,2,5056,165136398,256059356,0.644915
2529,1,2529,165138927,256059356,0.644924
2530,2,5060,165143987,256059356,0.644944
2531,1,2531,165146518,256059356,0.644954
2532,4,10128,165156646,256059356,0.644994
2533,2,5066,165161712,256059356,0.645013
2534,1,2534,165164246,256059356,0.645023
2535,2,5070,165169316,256059356,0.645043
2537,1,2537,165171853,256059356,0.645053
2538,1,2538,165174391,256059356,0.645063
2540,2,5080,165179471,256059356,0.645083
2541,2,5082,165184553,256059356,0.645103
2542,1,2542,165187095,256059356,0.645113
2543,1,2543,165189638,256059356,0.645122
2545,3,7635,165197273,256059356,0.645152
2546,2,5092,165202365,256059356,0.645172
2547,1,2547,165204912,256059356,0.645182
2548,2,5096,165210008,256059356,0.645202
2552,2,5104,165215112,256059356,0.645222
2554,2,5108,165220220,256059356,0.645242
2555,1,2555,165222775,256059356,0.645252
2557,2,5114,165227889,256059356,0.645272
2558,2,5116,165233005,256059356,0.645292
2559,3,7677,165240682,256059356,0.645322
2560,1,2560,165243242,256059356,0.645332
2561,1,2561,165245803,256059356,0.645342
2563,2,5126,165250929,256059356,0.645362
2564,2,5128,165256057,256059356,0.645382
2565,2,5130,165261187,256059356,0.645402
2566,2,5132,165266319,256059356,0.645422
2567,2,5134,165271453,256059356,0.645442
2568,2,5136,165276589,256059356,0.645462
2570,2,5140,165281729,256059356,0.645482
2572,1,2572,165284301,256059356,0.645492
2573,1,2573,165286874,256059356,0.645502
2574,4,10296,165297170,256059356,0.645542
2575,4,10300,165307470,256059356,0.645583
2576,1,2576,165310046,256059356,0.645593
2577,1,2577,165312623,256059356,0.645603
2578,2,5156,165317779,256059356,0.645623
2579,1,2579,165320358,256059356,0.645633
2580,3,7740,165328098,256059356,0.645663
2581,2,5162,165333260,256059356,0.645683
2582,3,7746,165341006,256059356,0.645714
2583,1,2583,165343589,256059356,0.645724
2585,2,5170,165348759,256059356,0.645744
2586,1,2586,165351345,256059356,0.645754
2587,1,2587,165353932,256059356,0.645764
2588,1,2588,165356520,256059356,0.645774
2590,1,2590,165359110,256059356,0.645784
2591,4,10364,165369474,256059356,0.645825
2592,3,7776,165377250,256059356,0.645855
2593,2,5186,165382436,256059356,0.645875
2594,1,2594,165385030,256059356,0.645886
2595,1,2595,165387625,256059356,0.645896
2601,3,7803,165395428,256059356,0.645926
2602,1,2602,165398030,256059356,0.645936
2605,1,2605,165400635,256059356,0.645946
2606,1,2606,165403241,256059356,0.645957
2608,1,2608,165405849,256059356,0.645967
2609,4,10436,165416285,256059356,0.646008
2610,1,2610,165418895,256059356,0.646018
2612,1,2612,165421507,256059356,0.646028
2613,3,7839,165429346,256059356,0.646059
2615,2,5230,165434576,256059356,0.646079
2617,2,5234,165439810,256059356,0.646099
2618,3,7854,165447664,256059356,0.64613
2619,4,10476,165458140,256059356,0.646171
2620,1,2620,165460760,256059356,0.646181
2622,2,5244,165466004,256059356,0.646202
2623,2,5246,165471250,256059356,0.646222
2624,5,13120,165484370,256059356,0.646273
2625,1,2625,165486995,256059356,0.646284
2626,1,2626,165489621,256059356,0.646294
2627,2,5254,165494875,256059356,0.646315
2628,4,10512,165505387,256059356,0.646356
2629,1,2629,165508016,256059356,0.646366
2630,3,7890,165515906,256059356,0.646397
2631,4,10524,165526430,256059356,0.646438
2633,2,5266,165531696,256059356,0.646458
2635,1,2635,165534331,256059356,0.646469
2636,1,2636,165536967,256059356,0.646479
2637,2,5274,165542241,256059356,0.646499
2638,2,5276,165547517,256059356,0.64652
2639,3,7917,165555434,256059356,0.646551
2640,4,10560,165565994,256059356,0.646592
2641,1,2641,165568635,256059356,0.646603
2642,2,5284,165573919,256059356,0.646623
2643,1,2643,165576562,256059356,0.646634
2644,2,5288,165581850,256059356,0.646654
2645,1,2645,165584495,256059356,0.646664
2646,4,10584,165595079,256059356,0.646706
2647,3,7941,165603020,256059356,0.646737
2650,1,2650,165605670,256059356,0.646747
2651,2,5302,165610972,256059356,0.646768
2652,1,2652,165613624,256059356,0.646778
2653,1,2653,165616277,256059356,0.646789
2654,1,2654,165618931,256059356,0.646799
2658,1,2658,165621589,256059356,0.646809
2661,2,5322,165626911,256059356,0.64683
2662,1,2662,165629573,256059356,0.646841
2663,1,2663,165632236,256059356,0.646851
2664,3,7992,165640228,256059356,0.646882
2665,5,13325,165653553,256059356,0.646934
2666,2,5332,165658885,256059356,0.646955
2667,1,2667,165661552,256059356,0.646965
2668,1,2668,165664220,256059356,0.646976
2670,1,2670,165666890,256059356,0.646986
2671,2,5342,165672232,256059356,0.647007
2672,1,2672,165674904,256059356,0.647018
2674,3,8022,165682926,256059356,0.647049
2675,1,2675,165685601,256059356,0.647059
2677,1,2677,165688278,256059356,0.64707
2678,3,8034,165696312,256059356,0.647101
2679,1,2679,165698991,256059356,0.647112
2680,2,5360,165704351,256059356,0.647133
2681,1,2681,165707032,256059356,0.647143
2684,2,5368,165712400,256059356,0.647164
2685,1,2685,165715085,256059356,0.647174
2686,1,2686,165717771,256059356,0.647185
2687,3,8061,165725832,256059356,0.647216
2688,1,2688,165728520,256059356,0.647227
2689,1,2689,165731209,256059356,0.647237
2690,2,5380,165736589,256059356,0.647258
2691,1,2691,165739280,256059356,0.647269
2692,2,5384,165744664,256059356,0.64729
2693,2,5386,165750050,256059356,0.647311
2695,2,5390,165755440,256059356,0.647332
2697,2,5394,165760834,256059356,0.647353
2700,2,5400,165766234,256059356,0.647374
2701,6,16206,165782440,256059356,0.647438
2702,4,10808,165793248,256059356,0.64748
2704,2,5408,165798656,256059356,0.647501
2706,1,2706,165801362,256059356,0.647511
2707,3,8121,165809483,256059356,0.647543
2708,3,8124,165817607,256059356,0.647575
2709,1,2709,165820316,256059356,0.647585
2710,5,13550,165833866,256059356,0.647638
2711,1,2711,165836577,256059356,0.647649
2713,1,2713,165839290,256059356,0.64766
2714,1,2714,165842004,256059356,0.64767
2715,3,8145,165850149,256059356,0.647702
2718,1,2718,165852867,256059356,0.647713
2719,2,5438,165858305,256059356,0.647734
2720,2,5440,165863745,256059356,0.647755
2722,1,2722,165866467,256059356,0.647766
2723,1,2723,165869190,256059356,0.647776
2724,1,2724,165871914,256059356,0.647787
2725,4,10900,165882814,256059356,0.64783
2728,2,5456,165888270,256059356,0.647851
2729,1,2729,165890999,256059356,0.647862
2730,1,2730,165893729,256059356,0.647872
2731,1,2731,165896460,256059356,0.647883
2732,1,2732,165899192,256059356,0.647893
2733,3,8199,165907391,256059356,0.647926
2734,1,2734,165910125,256059356,0.647936
2736,1,2736,165912861,256059356,0.647947
2738,3,8214,165921075,256059356,0.647979
2739,2,5478,165926553,256059356,0.648
2740,1,2740,165929293,256059356,0.648011
2742,1,2742,165932035,256059356,0.648022
2743,2,5486,165937521,256059356,0.648043
2746,3,8238,165945759,256059356,0.648075
2747,2,5494,165951253,256059356,0.648097
2748,2,5496,165956749,256059356,0.648118
2749,1,2749,165959498,256059356,0.648129
2750,2,5500,165964998,256059356,0.64815
2752,1,2752,165967750,256059356,0.648161
2753,2,5506,165973256,256059356,0.648183
2756,1,2756,165976012,256059356,0.648194
2757,1,2757,165978769,256059356,0.648204
2758,2,5516,165984285,256059356,0.648226
2760,1,2760,165987045,256059356,0.648237
2761,1,2761,165989806,256059356,0.648247
2762,2,5524,165995330,256059356,0.648269
2765,3,8295,166003625,256059356,0.648301
2766,2,5532,166009157,256059356,0.648323
2767,3,8301,166017458,256059356,0.648355
2768,1,2768,166020226,256059356,0.648366
2770,1,2770,166022996,256059356,0.648377
2771,2,5542,166028538,256059356,0.648399
2772,1,2772,166031310,256059356,0.648409
2773,1,2773,166034083,256059356,0.64842
2776,2,5552,166039635,256059356,0.648442
2779,1,2779,166042414,256059356,0.648453
2780,2,5560,166047974,256059356,0.648475
2781,1,2781,166050755,256059356,0.648485
2783,3,8349,166059104,256059356,0.648518
2784,2,5568,166064672,256059356,0.64854
2785,1,2785,166067457,256059356,0.648551
2786,1,2786,166070243,256059356,0.648562
2788,2,5576,166075819,256059356,0.648583
2789,1,2789,166078608,256059356,0.648594
2790,1,2790,166081398,256059356,0.648605
2791,2,5582,166086980,256059356,0.648627
2793,2,5586,166092566,256059356,0.648649
2794,4,11176,166103742,256059356,0.648692
2796,3,8388,166112130,256059356,0.648725
2798,1,2798,166114928,256059356,0.648736
2801,1,2801,166117729,256059356,0.648747
2802,4,11208,166128937,256059356,0.648791
2803,1,2803,166131740,256059356,0.648802
2806,2,5612,166137352,256059356,0.648824
2807,1,2807,166140159,256059356,0.648835
2809,2,5618,166145777,256059356,0.648856
2810,2,5620,166151397,256059356,0.648878
2811,3,8433,166159830,256059356,0.648911
2812,3,8436,166168266,256059356,0.648944
2814,1,2814,166171080,256059356,0.648955
2815,1,2815,166173895,256059356,0.648966
2817,1,2817,166176712,256059356,0.648977
2819,1,2819,166179531,256059356,0.648988
2821,1,2821,166182352,256059356,0.648999
2822,1,2822,166185174,256059356,0.64901
2824,1,2824,166187998,256059356,0.649021
2825,1,2825,166190823,256059356,0.649032
2826,1,2826,166193649,256059356,0.649043
2827,2,5654,166199303,256059356,0.649066
2828,2,5656,166204959,256059356,0.649088
2831,3,8493,166213452,256059356,0.649121
2832,1,2832,166216284,256059356,0.649132
2833,2,5666,166221950,256059356,0.649154
2834,3,8502,166230452,256059356,0.649187
2835,2,5670,166236122,256059356,0.649209
2838,2,5676,166241798,256059356,0.649231
2839,5,14195,166255993,256059356,0.649287
2840,1,2840,166258833,256059356,0.649298
2842,2,5684,166264517,256059356,0.64932
2843,1,2843,166267360,256059356,0.649331
2844,1,2844,166270204,256059356,0.649342
2845,3,8535,166278739,256059356,0.649376
2846,1,2846,166281585,256059356,0.649387
2847,1,2847,166284432,256059356,0.649398
2848,3,8544,166292976,256059356,0.649431
2849,1,2849,166295825,256059356,0.649442
2850,1,2850,166298675,256059356,0.649454
2852,1,2852,166301527,256059356,0.649465
2853,2,5706,166307233,256059356,0.649487
2857,1,2857,166310090,256059356,0.649498
2858,1,2858,166312948,256059356,0.649509
2862,4,11448,166324396,256059356,0.649554
2863,1,2863,166327259,256059356,0.649565
2864,3,8592,166335851,256059356,0.649599
2865,2,5730,166341581,256059356,0.649621
2866,2,5732,166347313,256059356,0.649644
2867,1,2867,166350180,256059356,0.649655
2868,3,8604,166358784,256059356,0.649688
2869,1,2869,166361653,256059356,0.6497
2872,1,2872,166364525,256059356,0.649711
2873,2,5746,166370271,256059356,0.649733
2874,2,5748,166376019,256059356,0.649756
2877,1,2877,166378896,256059356,0.649767
2878,1,2878,166381774,256059356,0.649778
2882,2,5764,166387538,256059356,0.649801
2883,2,5766,166393304,256059356,0.649823
2884,1,2884,166396188,256059356,0.649834
2885,1,2885,166399073,256059356,0.649846
2886,3,8658,166407731,256059356,0.64988
2887,3,8661,166416392,256059356,0.649913
2888,1,2888,166419280,256059356,0.649925
2889,2,5778,166425058,256059356,0.649947
2891,1,2891,166427949,256059356,0.649958
2893,1,2893,166430842,256059356,0.64997
2894,2,5788,166436630,256059356,0.649992
2895,3,8685,166445315,256059356,0.650026
2897,2,5794,166451109,256059356,0.650049
2898,2,5796,166456905,256059356,0.650072
2899,2,5798,166462703,256059356,0.650094
2901,3,8703,166471406,256059356,0.650128
2902,1,2902,166474308,256059356,0.65014
2903,1,2903,166477211,256059356,0.650151
2904,1,2904,166480115,256059356,0.650162
2905,4,11620,166491735,256059356,0.650208
2906,1,2906,166494641,256059356,0.650219
2908,2,5816,166500457,256059356,0.650242
2909,1,2909,166503366,256059356,0.650253
2911,2,5822,166509188,256059356,0.650276
2913,1,2913,166512101,256059356,0.650287
2914,1,2914,166515015,256059356,0.650298
2915,1,2915,166517930,256059356,0.65031
2916,3,8748,166526678,256059356,0.650344
2917,3,8751,166535429,256059356,0.650378
2918,1,2918,166538347,256059356,0.65039
2919,1,2919,166541266,256059356,0.650401
2920,1,2920,166544186,256059356,0.650412
2921,3,8763,166552949,256059356,0.650447
2922,1,2922,166555871,256059356,0.650458
2923,1,2923,166558794,256059356,0.650469
2925,2,5850,166564644,256059356,0.650492
2926,1,2926,166567570,256059356,0.650504
2927,2,5854,166573424,256059356,0.650527
2930,2,5860,166579284,256059356,0.650549
2932,1,2932,166582216,256059356,0.650561
2934,3,8802,166591018,256059356,0.650595
2935,1,2935,166593953,256059356,0.650607
2936,1,2936,166596889,256059356,0.650618
2938,2,5876,166602765,256059356,0.650641
2940,1,2940,166605705,256059356,0.650653
2941,1,2941,166608646,256059356,0.650664
2942,2,5884,166614530,256059356,0.650687
2948,2,5896,166620426,256059356,0.65071
2949,1,2949,166623375,256059356,0.650722
2950,1,2950,166626325,256059356,0.650733
2951,1,2951,166629276,256059356,0.650745
2953,3,8859,166638135,256059356,0.650779
2954,1,2954,166641089,256059356,0.650791
2955,1,2955,166644044,256059356,0.650802
2956,2,5912,166649956,256059356,0.650825
2957,1,2957,166652913,256059356,0.650837
2958,3,8874,166661787,256059356,0.650872
2959,3,8877,166670664,256059356,0.650906
2960,3,8880,166679544,256059356,0.650941
2965,1,2965,166682509,256059356,0.650953
2967,3,8901,166691410,256059356,0.650987
2968,2,5936,166697346,256059356,0.651011
2971,1,2971,166700317,256059356,0.651022
2974,1,2974,166703291,256059356,0.651034
2976,1,2976,166706267,256059356,0.651045
2977,1,2977,166709244,256059356,0.651057
2978,1,2978,166712222,256059356,0.651069
2984,1,2984,166715206,256059356,0.65108
2985,3,8955,166724161,256059356,0.651115
2986,2,5972,166730133,256059356,0.651139
2988,3,8964,166739097,256059356,0.651174
2990,1,2990,166742087,256059356,0.651185
2992,2,5984,166748071,256059356,0.651209
2993,2,5986,166754057,256059356,0.651232
2994,1,2994,166757051,256059356,0.651244
2995,2,5990,166763041,256059356,0.651267
2996,1,2996,166766037,256059356,0.651279
2997,1,2997,166769034,256059356,0.651291
2998,1,2998,166772032,256059356,0.651302
2999,1,2999,166775031,256059356,0.651314
3002,1,3002,166778033,256059356,0.651326
3003,1,3003,166781036,256059356,0.651337
3007,1,3007,166784043,256059356,0.651349
3009,3,9027,166793070,256059356,0.651384
3015,2,6030,166799100,256059356,0.651408
3017,1,3017,166802117,256059356,0.65142
3018,1,3018,166805135,256059356,0.651432
3020,1,3020,166808155,256059356,0.651443
3023,2,6046,166814201,256059356,0.651467
3024,2,6048,166820249,256059356,0.651491
3029,2,6058,166826307,256059356,0.651514
3030,2,6060,166832367,256059356,0.651538
3031,2,6062,166838429,256059356,0.651562
3032,1,3032,166841461,256059356,0.651573
3035,1,3035,166844496,256059356,0.651585
3038,3,9114,166853610,256059356,0.651621
3039,1,3039,166856649,256059356,0.651633
3040,3,9120,166865769,256059356,0.651668
3041,2,6082,166871851,256059356,0.651692
3042,1,3042,166874893,256059356,0.651704
3043,3,9129,166884022,256059356,0.65174
3046,1,3046,166887068,256059356,0.651751
3047,1,3047,166890115,256059356,0.651763
3048,1,3048,166893163,256059356,0.651775
3049,1,3049,166896212,256059356,0.651787
3051,1,3051,166899263,256059356,0.651799
3054,1,3054,166902317,256059356,0.651811
3055,1,3055,166905372,256059356,0.651823
3058,1,3058,166908430,256059356,0.651835
3060,2,6120,166914550,256059356,0.651859
3061,2,6122,166920672,256059356,0.651883
3063,1,3063,166923735,256059356,0.651895
3065,1,3065,166926800,256059356,0.651907
3067,1,3067,166929867,256059356,0.651919
3068,1,3068,166932935,256059356,0.651931
3073,1,3073,166936008,256059356,0.651943
3078,3,9234,166945242,256059356,0.651979
3079,2,6158,166951400,256059356,0.652003
3080,3,9240,166960640,256059356,0.652039
3081,2,6162,166966802,256059356,0.652063
3082,2,6164,166972966,256059356,0.652087
3083,1,3083,166976049,256059356,0.652099
3084,1,3084,166979133,256059356,0.652111
3085,1,3085,166982218,256059356,0.652123
3086,1,3086,166985304,256059356,0.652135
3088,1,3088,166988392,256059356,0.652147
3089,1,3089,166991481,256059356,0.652159
3090,2,6180,166997661,256059356,0.652183
3091,1,3091,167000752,256059356,0.652195
3092,1,3092,167003844,256059356,0.652208
3095,1,3095,167006939,256059356,0.65222
3096,1,3096,167010035,256059356,0.652232
3097,3,9291,167019326,256059356,0.652268
3100,3,9300,167028626,256059356,0.652304
3101,1,3101,167031727,256059356,0.652316
3102,1,3102,167034829,256059356,0.652329
3104,1,3104,167037933,256059356,0.652341
3105,1,3105,167041038,256059356,0.652353
3106,1,3106,167044144,256059356,0.652365
3109,1,3109,167047253,256059356,0.652377
3110,2,6220,167053473,256059356,0.652401
3111,3,9333,167062806,256059356,0.652438
3113,2,6226,167069032,256059356,0.652462
3115,1,3115,167072147,256059356,0.652474
3116,2,6232,167078379,256059356,0.652499
3118,2,6236,167084615,256059356,0.652523
3120,1,3120,167087735,256059356,0.652535
3121,1,3121,167090856,256059356,0.652547
3122,2,6244,167097100,256059356,0.652572
3124,1,3124,167100224,256059356,0.652584
3127,3,9381,167109605,256059356,0.652621
3128,1,3128,167112733,256059356,0.652633
3129,2,6258,167118991,256059356,0.652657
3130,2,6260,167125251,256059356,0.652682
3132,1,3132,167128383,256059356,0.652694
3135,1,3135,167131518,256059356,0.652706
3136,2,6272,167137790,256059356,0.652731
3137,1,3137,167140927,256059356,0.652743
3139,1,3139,167144066,256059356,0.652755
3141,1,3141,167147207,256059356,0.652767
3142,6,18852,167166059,256059356,0.652841
3143,1,3143,167169202,256059356,0.652853
3145,1,3145,167172347,256059356,0.652866
3146,1,3146,167175493,256059356,0.652878
3147,5,15735,167191228,256059356,0.652939
3148,1,3148,167194376,256059356,0.652952
3150,4,12600,167206976,256059356,0.653001
3151,1,3151,167210127,256059356,0.653013
3154,1,3154,167213281,256059356,0.653025
3156,1,3156,167216437,256059356,0.653038
3157,1,3157,167219594,256059356,0.65305
3158,1,3158,167222752,256059356,0.653062
3161,5,15805,167238557,256059356,0.653124
3162,2,6324,167244881,256059356,0.653149
3164,4,12656,167257537,256059356,0.653198
3166,2,6332,167263869,256059356,0.653223
3167,1,3167,167267036,256059356,0.653235
3168,1,3168,167270204,256059356,0.653248
3169,3,9507,167279711,256059356,0.653285
3170,2,6340,167286051,256059356,0.65331
3174,2,6348,167292399,256059356,0.653334
3177,2,6354,167298753,256059356,0.653359
3179,1,3179,167301932,256059356,0.653372
3181,1,3181,167305113,256059356,0.653384
3184,1,3184,167308297,256059356,0.653397
3185,1,3185,167311482,256059356,0.653409
3186,2,6372,167317854,256059356,0.653434
3187,3,9561,167327415,256059356,0.653471
3188,2,6376,167333791,256059356,0.653496
3190,1,3190,167336981,256059356,0.653509
3191,1,3191,167340172,256059356,0.653521
3194,2,6388,167346560,256059356,0.653546
3195,1,3195,167349755,256059356,0.653558
3197,3,9591,167359346,256059356,0.653596
3198,1,3198,167362544,256059356,0.653608
3200,1,3200,167365744,256059356,0.653621
3201,1,3201,167368945,256059356,0.653633
3206,3,9618,167378563,256059356,0.653671
3208,2,6416,167384979,256059356,0.653696
3209,1,3209,167388188,256059356,0.653709
3210,1,3210,167391398,256059356,0.653721
3212,2,6424,167397822,256059356,0.653746
3213,2,6426,167404248,256059356,0.653771
3215,2,6430,167410678,256059356,0.653796
3217,1,3217,167413895,256059356,0.653809
3218,2,6436,167420331,256059356,0.653834
3220,2,6440,167426771,256059356,0.653859
3221,1,3221,167429992,256059356,0.653872
3222,1,3222,167433214,256059356,0.653884
3223,1,3223,167436437,256059356,0.653897
3225,1,3225,167439662,256059356,0.65391
3226,1,3226,167442888,256059356,0.653922
3229,3,9687,167452575,256059356,0.65396
3230,2,6460,167459035,256059356,0.653985
3232,1,3232,167462267,256059356,0.653998
3235,2,6470,167468737,256059356,0.654023
3236,1,3236,167471973,256059356,0.654036
3237,1,3237,167475210,256059356,0.654048
3238,1,3238,167478448,256059356,0.654061
3239,1,3239,167481687,256059356,0.654074
3241,1,3241,167484928,256059356,0.654086
3242,1,3242,167488170,256059356,0.654099
3243,1,3243,167491413,256059356,0.654112
3244,3,9732,167501145,256059356,0.65415
3245,1,3245,167504390,256059356,0.654162
3247,1,3247,167507637,256059356,0.654175
3252,2,6504,167514141,256059356,0.6542
3255,2,6510,167520651,256059356,0.654226
3257,4,13028,167533679,256059356,0.654277
3258,1,3258,167536937,256059356,0.654289
3259,1,3259,167540196,256059356,0.654302
3261,1,3261,167543457,256059356,0.654315
3262,2,6524,167549981,256059356,0.65434
3263,2,6526,167556507,256059356,0.654366
3265,1,3265,167559772,256059356,0.654379
3267,1,3267,167563039,256059356,0.654391
3268,2,6536,167569575,256059356,0.654417
3269,2,6538,167576113,256059356,0.654442
3270,1,3270,167579383,256059356,0.654455
3271,1,3271,167582654,256059356,0.654468
3273,1,3273,167585927,256059356,0.654481
3276,1,3276,167589203,256059356,0.654494
3277,2,6554,167595757,256059356,0.654519
3278,1,3278,167599035,256059356,0.654532
3280,3,9840,167608875,256059356,0.65457
3281,3,9843,167618718,256059356,0.654609
3284,2,6568,167625286,256059356,0.654634
3289,1,3289,167628575,256059356,0.654647
3290,2,6580,167635155,256059356,0.654673
3292,1,3292,167638447,256059356,0.654686
3293,2,6586,167645033,256059356,0.654712
3297,1,3297,167648330,256059356,0.654724
3299,1,3299,167651629,256059356,0.654737
3301,2,6602,167658231,256059356,0.654763
3302,1,3302,167661533,256059356,0.654776
3303,1,3303,167664836,256059356,0.654789
3304,2,6608,167671444,256059356,0.654815
3306,2,6612,167678056,256059356,0.654841
3308,2,6616,167684672,256059356,0.654866
3309,1,3309,167687981,256059356,0.654879
3311,3,9933,167697914,256059356,0.654918
3315,1,3315,167701229,256059356,0.654931
3316,1,3316,167704545,256059356,0.654944
3317,4,13268,167717813,256059356,0.654996
3318,2,6636,167724449,256059356,0.655022
3319,2,6638,167731087,256059356,0.655048
3321,3,9963,167741050,256059356,0.655087
3322,1,3322,167744372,256059356,0.6551
3323,1,3323,167747695,256059356,0.655113
3326,2,6652,167754347,256059356,0.655139
3327,1,3327,167757674,256059356,0.655152
3329,1,3329,167761003,256059356,0.655165
3331,2,6662,167767665,256059356,0.655191
3332,1,3332,167770997,256059356,0.655204
3336,1,3336,167774333,256059356,0.655217
3339,3,10017,167784350,256059356,0.655256
3340,2,6680,167791030,256059356,0.655282
3342,4,13368,167804398,256059356,0.655334
3343,2,6686,167811084,256059356,0.65536
3345,2,6690,167817774,256059356,0.655386
3346,2,6692,167824466,256059356,0.655412
3347,1,3347,167827813,256059356,0.655425
3348,1,3348,167831161,256059356,0.655439
3350,1,3350,167834511,256059356,0.655452
3352,2,6704,167841215,256059356,0.655478
3353,2,6706,167847921,256059356,0.655504
3354,2,6708,167854629,256059356,0.65553
3355,2,6710,167861339,256059356,0.655556
3356,1,3356,167864695,256059356,0.655569
3357,3,10071,167874766,256059356,0.655609
3358,1,3358,167878124,256059356,0.655622
3359,2,6718,167884842,256059356,0.655648
3361,1,3361,167888203,256059356,0.655661
3362,1,3362,167891565,256059356,0.655674
3364,2,6728,167898293,256059356,0.655701
3366,2,6732,167905025,256059356,0.655727
3367,1,3367,167908392,256059356,0.65574
3368,4,13472,167921864,256059356,0.655793
3371,1,3371,167925235,256059356,0.655806
3373,2,6746,167931981,256059356,0.655832
3375,1,3375,167935356,256059356,0.655845
3376,1,3376,167938732,256059356,0.655859
3377,2,6754,167945486,256059356,0.655885
3379,2,6758,167952244,256059356,0.655911
3381,1,3381,167955625,256059356,0.655925
3382,2,6764,167962389,256059356,0.655951
3383,1,3383,167965772,256059356,0.655964
3385,1,3385,167969157,256059356,0.655977
3386,4,13544,167982701,256059356,0.65603
3387,6,20322,168003023,256059356,0.65611
3388,1,3388,168006411,256059356,0.656123
3393,2,6786,168013197,256059356,0.656149
3396,1,3396,168016593,256059356,0.656163
3397,1,3397,168019990,256059356,0.656176
3398,1,3398,168023388,256059356,0.656189
3399,1,3399,168026787,256059356,0.656202
3400,2,6800,168033587,256059356,0.656229
3405,1,3405,168036992,256059356,0.656242
3411,1,3411,168040403,256059356,0.656256
3413,1,3413,168043816,256059356,0.656269
3416,1,3416,168047232,256059356,0.656282
3418,3,10254,168057486,256059356,0.656322
3419,3,10257,168067743,256059356,0.656362
3422,1,3422,168071165,256059356,0.656376
3424,2,6848,168078013,256059356,0.656403
3425,2,6850,168084863,256059356,0.656429
3426,1,3426,168088289,256059356,0.656443
3427,1,3427,168091716,256059356,0.656456
3429,1,3429,168095145,256059356,0.656469
3431,1,3431,168098576,256059356,0.656483
3432,4,13728,168112304,256059356,0.656536
3435,1,3435,168115739,256059356,0.65655
3436,2,6872,168122611,256059356,0.656577
3438,1,3438,168126049,256059356,0.65659
3439,1,3439,168129488,256059356,0.656604
3441,1,3441,168132929,256059356,0.656617
3442,1,3442,168136371,256059356,0.65663
3443,1,3443,168139814,256059356,0.656644
3444,1,3444,168143258,256059356,0.656657
3446,1,3446,168146704,256059356,0.656671
3448,1,3448,168150152,256059356,0.656684
3449,1,3449,168153601,256059356,0.656698
3450,5,17250,168170851,256059356,0.656765
3451,2,6902,168177753,256059356,0.656792
3452,2,6904,168184657,256059356,0.656819
3457,3,10371,168195028,256059356,0.65686
3460,1,3460,168198488,256059356,0.656873
3463,1,3463,168201951,256059356,0.656887
3464,3,10392,168212343,256059356,0.656927
3468,1,3468,168215811,256059356,0.656941
3469,2,6938,168222749,256059356,0.656968
3472,1,3472,168226221,256059356,0.656981
3473,2,6946,168233167,256059356,0.657008
3479,1,3479,168236646,256059356,0.657022
3480,1,3480,168240126,256059356,0.657036
3483,2,6966,168247092,256059356,0.657063
3484,1,3484,168250576,256059356,0.657076
3487,1,3487,168254063,256059356,0.65709
3493,1,3493,168257556,256059356,0.657104
3494,2,6988,168264544,256059356,0.657131
3497,1,3497,168268041,256059356,0.657145
3499,1,3499,168271540,256059356,0.657158
3500,1,3500,168275040,256059356,0.657172
3501,1,3501,168278541,256059356,0.657186
3502,1,3502,168282043,256059356,0.657199
3507,2,7014,168289057,256059356,0.657227
3508,1,3508,168292565,256059356,0.65724
3509,1,3509,168296074,256059356,0.657254
3511,1,3511,168299585,256059356,0.657268
3513,1,3513,168303098,256059356,0.657282
3515,1,3515,168306613,256059356,0.657295
3516,1,3516,168310129,256059356,0.657309
3517,1,3517,168313646,256059356,0.657323
3518,1,3518,168317164,256059356,0.657337
3519,1,3519,168320683,256059356,0.65735
3520,1,3520,168324203,256059356,0.657364
3521,2,7042,168331245,256059356,0.657392
3522,1,3522,168334767,256059356,0.657405
3523,2,7046,168341813,256059356,0.657433
3524,4,14096,168355909,256059356,0.657488
3526,1,3526,168359435,256059356,0.657502
3527,5,17635,168377070,256059356,0.65757
3528,1,3528,168380598,256059356,0.657584
3529,1,3529,168384127,256059356,0.657598
3530,3,10590,168394717,256059356,0.657639
3531,3,10593,168405310,256059356,0.657681
3534,1,3534,168408844,256059356,0.657695
3535,4,14140,168422984,256059356,0.65775
3538,3,10614,168433598,256059356,0.657791
3539,1,3539,168437137,256059356,0.657805
3540,1,3540,168440677,256059356,0.657819
3541,2,7082,168447759,256059356,0.657847
3543,4,14172,168461931,256059356,0.657902
3545,2,7090,168469021,256059356,0.65793
3546,2,7092,168476113,256059356,0.657957
3547,2,7094,168483207,256059356,0.657985
3548,3,10644,168493851,256059356,0.658027
3549,1,3549,168497400,256059356,0.65804
3550,2,7100,168504500,256059356,0.658068
3551,1,3551,168508051,256059356,0.658082
3553,1,3553,168511604,256059356,0.658096
3554,1,3554,168515158,256059356,0.65811
3557,2,7114,168522272,256059356,0.658138
3558,1,3558,168525830,256059356,0.658151
3559,2,7118,168532948,256059356,0.658179
3562,1,3562,168536510,256059356,0.658193
3564,2,7128,168543638,256059356,0.658221
3565,1,3565,168547203,256059356,0.658235
3566,1,3566,168550769,256059356,0.658249
3567,1,3567,168554336,256059356,0.658263
3570,1,3570,168557906,256059356,0.658277
3574,4,14296,168572202,256059356,0.658333
3575,1,3575,168575777,256059356,0.658346
3581,1,3581,168579358,256059356,0.65836
3582,1,3582,168582940,256059356,0.658374
3583,1,3583,168586523,256059356,0.658388
3587,2,7174,168593697,256059356,0.658416
3588,1,3588,168597285,256059356,0.65843
3590,1,3590,168600875,256059356,0.658445
3592,1,3592,168604467,256059356,0.658459
3593,1,3593,168608060,256059356,0.658473
3594,1,3594,168611654,256059356,0.658487
3595,2,7190,168618844,256059356,0.658515
3596,1,3596,168622440,256059356,0.658529
3597,2,7194,168629634,256059356,0.658557
3598,3,10794,168640428,256059356,0.658599
3599,1,3599,168644027,256059356,0.658613
3600,1,3600,168647627,256059356,0.658627
3602,2,7204,168654831,256059356,0.658655
3603,2,7206,168662037,256059356,0.658683
3604,1,3604,168665641,256059356,0.658697
3606,2,7212,168672853,256059356,0.658726
3607,1,3607,168676460,256059356,0.65874
3608,1,3608,168680068,256059356,0.658754
3610,1,3610,168683678,256059356,0.658768
3611,1,3611,168687289,256059356,0.658782
3614,1,3614,168690903,256059356,0.658796
3615,1,3615,168694518,256059356,0.65881
3616,1,3616,168698134,256059356,0.658824
3617,2,7234,168705368,256059356,0.658853
3618,1,3618,168708986,256059356,0.658867
3623,1,3623,168712609,256059356,0.658881
3624,1,3624,168716233,256059356,0.658895
3625,1,3625,168719858,256059356,0.658909
3627,1,3627,168723485,256059356,0.658923
3631,1,3631,168727116,256059356,0.658938
3634,3,10902,168738018,256059356,0.65898
3635,1,3635,168741653,256059356,0.658994
3636,1,3636,168745289,256059356,0.659008
3638,1,3638,168748927,256059356,0.659023
3639,1,3639,168752566,256059356,0.659037
3641,1,3641,168756207,256059356,0.659051
3642,1,3642,168759849,256059356,0.659065
3643,1,3643,168763492,256059356,0.65908
3644,4,14576,168778068,256059356,0.659137
3645,1,3645,168781713,256059356,0.659151
3646,2,7292,168789005,256059356,0.659179
3647,1,3647,168792652,256059356,0.659193
3648,2,7296,168799948,256059356,0.659222
3652,1,3652,168803600,256059356,0.659236
3655,1,3655,168807255,256059356,0.65925
3658,2,7316,168814571,256059356,0.659279
3662,3,10986,168825557,256059356,0.659322
3666,1,3666,168829223,256059356,0.659336
3667,1,3667,168832890,256059356,0.659351
3668,1,3668,168836558,256059356,0.659365
3669,1,3669,168840227,256059356,0.659379
3670,1,3670,168843897,256059356,0.659394
3671,1,3671,168847568,256059356,0.659408
3673,2,7346,168854914,256059356,0.659437
3674,1,3674,168858588,256059356,0.659451
3675,2,7350,168865938,256059356,0.65948
3679,3,11037,168876975,256059356,0.659523
3680,1,3680,168880655,256059356,0.659537
3683,2,7366,168888021,256059356,0.659566
3684,3,11052,168899073,256059356,0.659609
3690,1,3690,168902763,256059356,0.659623
3693,1,3693,168906456,256059356,0.659638
3694,1,3694,168910150,256059356,0.659652
3696,1,3696,168913846,256059356,0.659667
3698,3,11094,168924940,256059356,0.65971
3700,1,3700,168928640,256059356,0.659725
3702,2,7404,168936044,256059356,0.659753
3703,1,3703,168939747,256059356,0.659768
3704,3,11112,168950859,256059356,0.659811
3707,1,3707,168954566,256059356,0.659826
3708,1,3708,168958274,256059356,0.65984
3710,1,3710,168961984,256059356,0.659855
3711,1,3711,168965695,256059356,0.659869
3712,1,3712,168969407,256059356,0.659884
3714,1,3714,168973121,256059356,0.659898
3715,1,3715,168976836,256059356,0.659913
3718,1,3718,168980554,256059356,0.659927
3719,3,11157,168991711,256059356,0.659971
3720,1,3720,168995431,256059356,0.659985
3722,2,7444,169002875,256059356,0.660014
3730,3,11190,169014065,256059356,0.660058
3731,2,7462,169021527,256059356,0.660087
3733,1,3733,169025260,256059356,0.660102
3735,2,7470,169032730,256059356,0.660131
3741,1,3741,169036471,256059356,0.660146
3743,2,7486,169043957,256059356,0.660175
3745,1,3745,169047702,256059356,0.66019
3749,1,3749,169051451,256059356,0.660204
3750,1,3750,169055201,256059356,0.660219
3751,3,11253,169066454,256059356,0.660263
3753,1,3753,169070207,256059356,0.660277
3755,2,7510,169077717,256059356,0.660307
3756,1,3756,169081473,256059356,0.660321
3757,1,3757,169085230,256059356,0.660336
3758,1,3758,169088988,256059356,0.660351
3759,1,3759,169092747,256059356,0.660365
3764,1,3764,169096511,256059356,0.66038
3770,1,3770,169100281,256059356,0.660395
3771,1,3771,169104052,256059356,0.66041
3772,1,3772,169107824,256059356,0.660424
3773,2,7546,169115370,256059356,0.660454
3775,1,3775,169119145,256059356,0.660469
3776,1,3776,169122921,256059356,0.660483
3777,3,11331,169134252,256059356,0.660528
3778,1,3778,169138030,256059356,0.660542
3781,1,3781,169141811,256059356,0.660557
3782,1,3782,169145593,256059356,0.660572
3783,1,3783,169149376,256059356,0.660587
3784,1,3784,169153160,256059356,0.660601
3785,3,11355,169164515,256059356,0.660646
3786,2,7572,169172087,256059356,0.660675
3787,1,3787,169175874,256059356,0.66069
3789,2,7578,169183452,256059356,0.66072
3791,2,7582,169191034,256059356,0.660749
3792,2,7584,169198618,256059356,0.660779
3794,1,3794,169202412,256059356,0.660794
3795,1,3795,169206207,256059356,0.660809
3796,2,7592,169213799,256059356,0.660838
3800,1,3800,169217599,256059356,0.660853
3801,1,3801,169221400,256059356,0.660868
3802,2,7604,169229004,256059356,0.660898
3803,2,7606,169236610,256059356,0.660927
3806,1,3806,169240416,256059356,0.660942
3809,2,7618,169248034,256059356,0.660972
3811,1,3811,169251845,256059356,0.660987
3812,1,3812,169255657,256059356,0.661002
3813,2,7626,169263283,256059356,0.661031
3814,2,7628,169270911,256059356,0.661061
3815,1,3815,169274726,256059356,0.661076
3816,1,3816,169278542,256059356,0.661091
3818,5,19090,169297632,256059356,0.661166
3825,1,3825,169301457,256059356,0.661181
3826,2,7652,169309109,256059356,0.66121
3828,2,7656,169316765,256059356,0.66124
3829,1,3829,169320594,256059356,0.661255
3830,1,3830,169324424,256059356,0.66127
3831,1,3831,169328255,256059356,0.661285
3833,1,3833,169332088,256059356,0.6613
3834,1,3834,169335922,256059356,0.661315
3835,1,3835,169339757,256059356,0.66133
3836,1,3836,169343593,256059356,0.661345
3837,4,15348,169358941,256059356,0.661405
3839,1,3839,169362780,256059356,0.66142
3842,3,11526,169374306,256059356,0.661465
3844,1,3844,169378150,256059356,0.66148
3848,1,3848,169381998,256059356,0.661495
3850,1,3850,169385848,256059356,0.66151
3853,2,7706,169393554,256059356,0.66154
3854,1,3854,169397408,256059356,0.661555
3855,1,3855,169401263,256059356,0.66157
3857,1,3857,169405120,256059356,0.661585
3859,2,7718,169412838,256059356,0.661615
3861,1,3861,169416699,256059356,0.661631
3864,1,3864,169420563,256059356,0.661646
3869,1,3869,169424432,256059356,0.661661
3870,1,3870,169428302,256059356,0.661676
3873,1,3873,169432175,256059356,0.661691
3874,1,3874,169436049,256059356,0.661706
3876,1,3876,169439925,256059356,0.661721
3877,1,3877,169443802,256059356,0.661736
3879,1,3879,169447681,256059356,0.661752
3880,1,3880,169451561,256059356,0.661767
3884,1,3884,169455445,256059356,0.661782
3886,2,7772,169463217,256059356,0.661812
3892,1,3892,169467109,256059356,0.661827
3894,1,3894,169471003,256059356,0.661843
3897,2,7794,169478797,256059356,0.661873
3902,1,3902,169482699,256059356,0.661888
3904,1,3904,169486603,256059356,0.661904
3906,1,3906,169490509,256059356,0.661919
3908,1,3908,169494417,256059356,0.661934
3910,1,3910,169498327,256059356,0.661949
3912,1,3912,169502239,256059356,0.661965
3914,1,3914,169506153,256059356,0.66198
3917,1,3917,169510070,256059356,0.661995
3922,2,7844,169517914,256059356,0.662026
3923,1,3923,169521837,256059356,0.662041
3924,3,11772,169533609,256059356,0.662087
3925,1,3925,169537534,256059356,0.662102
3928,1,3928,169541462,256059356,0.662118
3932,2,7864,169549326,256059356,0.662149
3935,2,7870,169557196,256059356,0.662179
3936,1,3936,169561132,256059356,0.662195
3937,2,7874,169569006,256059356,0.662225
3943,1,3943,169572949,256059356,0.662241
3945,1,3945,169576894,256059356,0.662256
3946,3,11838,169588732,256059356,0.662302
3947,2,7894,169596626,256059356,0.662333
3948,1,3948,169600574,256059356,0.662349
3954,1,3954,169604528,256059356,0.662364
3957,1,3957,169608485,256059356,0.66238
3960,4,15840,169624325,256059356,0.662441
3961,1,3961,169628286,256059356,0.662457
3963,1,3963,169632249,256059356,0.662472
3964,1,3964,169636213,256059356,0.662488
3966,2,7932,169644145,256059356,0.662519
3967,1,3967,169648112,256059356,0.662534
3968,1,3968,169652080,256059356,0.66255
3972,2,7944,169660024,256059356,0.662581
3977,1,3977,169664001,256059356,0.662596
3979,1,3979,169667980,256059356,0.662612
3980,1,3980,169671960,256059356,0.662627
3982,1,3982,169675942,256059356,0.662643
3984,1,3984,169679926,256059356,0.662659
3987,1,3987,169683913,256059356,0.662674
3988,1,3988,169687901,256059356,0.66269
3992,2,7984,169695885,256059356,0.662721
3997,1,3997,169699882,256059356,0.662737
3999,1,3999,169703881,256059356,0.662752
4001,1,4001,169707882,256059356,0.662768
4002,2,8004,169715886,256059356,0.662799
4005,1,4005,169719891,256059356,0.662815
4006,3,12018,169731909,256059356,0.662862
4007,1,4007,169735916,256059356,0.662877
4008,2,8016,169743932,256059356,0.662909
4009,2,8018,169751950,256059356,0.66294
4016,1,4016,169755966,256059356,0.662956
4021,1,4021,169759987,256059356,0.662971
4024,4,16096,169776083,256059356,0.663034
4026,3,12078,169788161,256059356,0.663081
4028,1,4028,169792189,256059356,0.663097
4029,2,8058,169800247,256059356,0.663128
4030,1,4030,169804277,256059356,0.663144
4032,1,4032,169808309,256059356,0.66316
4033,1,4033,169812342,256059356,0.663176
4035,1,4035,169816377,256059356,0.663191
4036,1,4036,169820413,256059356,0.663207
4040,1,4040,169824453,256059356,0.663223
4041,1,4041,169828494,256059356,0.663239
4044,2,8088,169836582,256059356,0.66327
4045,1,4045,169840627,256059356,0.663286
4048,1,4048,169844675,256059356,0.663302
4050,1,4050,169848725,256059356,0.663318
4056,1,4056,169852781,256059356,0.663334
4057,1,4057,169856838,256059356,0.663349
4060,1,4060,169860898,256059356,0.663365
4062,1,4062,169864960,256059356,0.663381
4067,2,8134,169873094,256059356,0.663413
4068,1,4068,169877162,256059356,0.663429
4069,2,8138,169885300,256059356,0.663461
4070,1,4070,169889370,256059356,0.663477
4073,1,4073,169893443,256059356,0.663492
4074,2,8148,169901591,256059356,0.663524
4076,2,8152,169909743,256059356,0.663556
4077,1,4077,169913820,256059356,0.663572
4080,3,12240,169926060,256059356,0.66362
4081,1,4081,169930141,256059356,0.663636
4082,2,8164,169938305,256059356,0.663668
4083,1,4083,169942388,256059356,0.663684
4086,1,4086,169946474,256059356,0.6637
4087,1,4087,169950561,256059356,0.663715
4091,1,4091,169954652,256059356,0.663731
4093,1,4093,169958745,256059356,0.663747
4096,1,4096,169962841,256059356,0.663763
4098,3,12294,169975135,256059356,0.663811
4099,1,4099,169979234,256059356,0.663827
4102,1,4102,169983336,256059356,0.663843
4109,2,8218,169991554,256059356,0.663876
4111,1,4111,169995665,256059356,0.663892
4114,1,4114,169999779,256059356,0.663908
4115,1,4115,170003894,256059356,0.663924
4116,2,8232,170012126,256059356,0.663956
4117,1,4117,170016243,256059356,0.663972
4118,2,8236,170024479,256059356,0.664004
4127,1,4127,170028606,256059356,0.66402
4128,1,4128,170032734,256059356,0.664036
4129,1,4129,170036863,256059356,0.664053
4131,2,8262,170045125,256059356,0.664085
4132,1,4132,170049257,256059356,0.664101
4139,2,8278,170057535,256059356,0.664133
4140,1,4140,170061675,256059356,0.664149
4141,1,4141,170065816,256059356,0.664166
4142,2,8284,170074100,256059356,0.664198
4143,3,12429,170086529,256059356,0.664246
4145,2,8290,170094819,256059356,0.664279
4149,1,4149,170098968,256059356,0.664295
4150,1,4150,170103118,256059356,0.664311
4156,1,4156,170107274,256059356,0.664328
4157,1,4157,170111431,256059356,0.664344
4158,1,4158,170115589,256059356,0.66436
4159,1,4159,170119748,256059356,0.664376
4160,1,4160,170123908,256059356,0.664392
4161,1,4161,170128069,256059356,0.664409
4171,1,4171,170132240,256059356,0.664425
4172,1,4172,170136412,256059356,0.664441
4173,2,8346,170144758,256059356,0.664474
4174,1,4174,170148932,256059356,0.66449
4175,1,4175,170153107,256059356,0.664507
4179,1,4179,170157286,256059356,0.664523
4180,1,4180,170161466,256059356,0.664539
4186,1,4186,170165652,256059356,0.664555
4187,1,4187,170169839,256059356,0.664572
4188,1,4188,170174027,256059356,0.664588
4194,1,4194,170178221,256059356,0.664605
4195,1,4195,170182416,256059356,0.664621
4198,1,4198,170186614,256059356,0.664637
4201,2,8402,170195016,256059356,0.66467
4204,1,4204,170199220,256059356,0.664687
4205,1,4205,170203425,256059356,0.664703
4209,4,16836,170220261,256059356,0.664769
4210,1,4210,170224471,256059356,0.664785
4211,1,4211,170228682,256059356,0.664802
4214,1,4214,170232896,256059356,0.664818
4216,1,4216,170237112,256059356,0.664835
4219,2,8438,170245550,256059356,0.664868
4222,1,4222,170249772,256059356,0.664884
4224,1,4224,170253996,256059356,0.664901
4226,2,8452,170262448,256059356,0.664934
4232,1,4232,170266680,256059356,0.66495
4233,1,4233,170270913,256059356,0.664967
4236,2,8472,170279385,256059356,0.665
4237,1,4237,170283622,256059356,0.665016
4240,1,4240,170287862,256059356,0.665033
4241,1,4241,170292103,256059356,0.665049
4242,1,4242,170296345,256059356,0.665066
4243,1,4243,170300588,256059356,0.665082
4244,1,4244,170304832,256059356,0.665099
4245,1,4245,170309077,256059356,0.665116
4246,1,4246,170313323,256059356,0.665132
4248,1,4248,170317571,256059356,0.665149
4250,1,4250,170321821,256059356,0.665165
4251,2,8502,170330323,256059356,0.665199
4256,1,4256,170334579,256059356,0.665215
4259,2,8518,170343097,256059356,0.665248
4266,1,4266,170347363,256059356,0.665265
4269,2,8538,170355901,256059356,0.665298
4270,1,4270,170360171,256059356,0.665315
4271,1,4271,170364442,256059356,0.665332
4276,1,4276,170368718,256059356,0.665349
4279,2,8558,170377276,256059356,0.665382
4282,1,4282,170381558,256059356,0.665399
4283,1,4283,170385841,256059356,0.665415
4284,1,4284,170390125,256059356,0.665432
4290,2,8580,170398705,256059356,0.665466
4291,1,4291,170402996,256059356,0.665482
4292,1,4292,170407288,256059356,0.665499
4295,1,4295,170411583,256059356,0.665516
4296,1,4296,170415879,256059356,0.665533
4298,1,4298,170420177,256059356,0.66555
4299,1,4299,170424476,256059356,0.665566
4302,1,4302,170428778,256059356,0.665583
4303,1,4303,170433081,256059356,0.6656
4305,1,4305,170437386,256059356,0.665617
4306,1,4306,170441692,256059356,0.665634
4307,1,4307,170445999,256059356,0.66565
4310,1,4310,170450309,256059356,0.665667
4311,1,4311,170454620,256059356,0.665684
4312,1,4312,170458932,256059356,0.665701
4313,2,8626,170467558,256059356,0.665735
4315,1,4315,170471873,256059356,0.665751
4316,1,4316,170476189,256059356,0.665768
4318,1,4318,170480507,256059356,0.665785
4322,1,4322,170484829,256059356,0.665802
4323,2,8646,170493475,256059356,0.665836
4325,3,12975,170506450,256059356,0.665886
4327,1,4327,170510777,256059356,0.665903
4329,1,4329,170515106,256059356,0.66592
4333,2,8666,170523772,256059356,0.665954
4335,1,4335,170528107,256059356,0.665971
4338,1,4338,170532445,256059356,0.665988
4339,1,4339,170536784,256059356,0.666005
4344,1,4344,170541128,256059356,0.666022
4347,2,8694,170549822,256059356,0.666056
4349,2,8698,170558520,256059356,0.66609
4350,1,4350,170562870,256059356,0.666107
4352,1,4352,170567222,256059356,0.666124
4353,1,4353,170571575,256059356,0.666141
4354,1,4354,170575929,256059356,0.666158
4360,1,4360,170580289,256059356,0.666175
4363,1,4363,170584652,256059356,0.666192
4364,1,4364,170589016,256059356,0.666209
4366,1,4366,170593382,256059356,0.666226
4372,1,4372,170597754,256059356,0.666243
4373,2,8746,170606500,256059356,0.666277
4375,1,4375,170610875,256059356,0.666294
4377,2,8754,170619629,256059356,0.666328
4379,1,4379,170624008,256059356,0.666346
4381,1,4381,170628389,256059356,0.666363
4383,1,4383,170632772,256059356,0.66638
4386,1,4386,170637158,256059356,0.666397
4389,1,4389,170641547,256059356,0.666414
4390,1,4390,170645937,256059356,0.666431
4391,1,4391,170650328,256059356,0.666448
4396,2,8792,170659120,256059356,0.666483
4397,1,4397,170663517,256059356,0.6665
4398,3,13194,170676711,256059356,0.666551
4399,1,4399,170681110,256059356,0.666569
4400,1,4400,170685510,256059356,0.666586
4401,1,4401,170689911,256059356,0.666603
4403,1,4403,170694314,256059356,0.66662
4409,1,4409,170698723,256059356,0.666637
4412,3,13236,170711959,256059356,0.666689
4413,2,8826,170720785,256059356,0.666723
4414,2,8828,170729613,256059356,0.666758
4420,1,4420,170734033,256059356,0.666775
4425,1,4425,170738458,256059356,0.666792
4427,2,8854,170747312,256059356,0.666827
4428,1,4428,170751740,256059356,0.666844
4431,1,4431,170756171,256059356,0.666862
4434,1,4434,170760605,256059356,0.666879
4436,1,4436,170765041,256059356,0.666896
4437,3,13311,170778352,256059356,0.666948
4439,1,4439,170782791,256059356,0.666966
4441,1,4441,170787232,256059356,0.666983
4442,2,8884,170796116,256059356,0.667018
4444,2,8888,170805004,256059356,0.667052
4445,2,8890,170813894,256059356,0.667087
4446,2,8892,170822786,256059356,0.667122
4447,1,4447,170827233,256059356,0.667139
4449,1,4449,170831682,256059356,0.667157
4451,2,8902,170840584,256059356,0.667191
4457,1,4457,170845041,256059356,0.667209
4458,1,4458,170849499,256059356,0.667226
4459,1,4459,170853958,256059356,0.667244
4460,2,8920,170862878,256059356,0.667278
4461,1,4461,170867339,256059356,0.667296
4462,1,4462,170871801,256059356,0.667313
4463,1,4463,170876264,256059356,0.667331
4464,1,4464,170880728,256059356,0.667348
4470,1,4470,170885198,256059356,0.667366
4471,1,4471,170889669,256059356,0.667383
4480,1,4480,170894149,256059356,0.667401
4481,1,4481,170898630,256059356,0.667418
4482,2,8964,170907594,256059356,0.667453
4483,1,4483,170912077,256059356,0.667471
4484,1,4484,170916561,256059356,0.667488
4485,1,4485,170921046,256059356,0.667506
4486,1,4486,170925532,256059356,0.667523
4487,1,4487,170930019,256059356,0.667541
4488,2,8976,170938995,256059356,0.667576
4489,1,4489,170943484,256059356,0.667593
4492,1,4492,170947976,256059356,0.667611
4493,3,13479,170961455,256059356,0.667663
4494,1,4494,170965949,256059356,0.667681
4496,1,4496,170970445,256059356,0.667698
4497,1,4497,170974942,256059356,0.667716
4500,1,4500,170979442,256059356,0.667734
4503,1,4503,170983945,256059356,0.667751
4504,1,4504,170988449,256059356,0.667769
4508,2,9016,170997465,256059356,0.667804
4510,1,4510,171001975,256059356,0.667822
4511,2,9022,171010997,256059356,0.667857
4512,3,13536,171024533,256059356,0.66791
4513,2,9026,171033559,256059356,0.667945
4520,2,9040,171042599,256059356,0.66798
4522,1,4522,171047121,256059356,0.667998
4523,1,4523,171051644,256059356,0.668016
4524,1,4524,171056168,256059356,0.668033
4527,1,4527,171060695,256059356,0.668051
4531,1,4531,171065226,256059356,0.668069
4533,1,4533,171069759,256059356,0.668086
4534,1,4534,171074293,256059356,0.668104
4537,1,4537,171078830,256059356,0.668122
4538,1,4538,171083368,256059356,0.668139
4540,1,4540,171087908,256059356,0.668157
4541,2,9082,171096990,256059356,0.668193
4546,3,13638,171110628,256059356,0.668246
4548,1,4548,171115176,256059356,0.668264
4550,1,4550,171119726,256059356,0.668281
4551,2,9102,171128828,256059356,0.668317
4553,1,4553,171133381,256059356,0.668335
4554,2,9108,171142489,256059356,0.66837
4558,1,4558,171147047,256059356,0.668388
4559,1,4559,171151606,256059356,0.668406
4561,1,4561,171156167,256059356,0.668424
4564,1,4564,171160731,256059356,0.668442
4567,1,4567,171165298,256059356,0.668459
4568,1,4568,171169866,256059356,0.668477
4569,4,18276,171188142,256059356,0.668549
4574,2,9148,171197290,256059356,0.668584
4576,2,9152,171206442,256059356,0.66862
4585,1,4585,171211027,256059356,0.668638
4586,1,4586,171215613,256059356,0.668656
4592,1,4592,171220205,256059356,0.668674
4597,1,4597,171224802,256059356,0.668692
4598,1,4598,171229400,256059356,0.66871
4599,1,4599,171233999,256059356,0.668728
4603,1,4603,171238602,256059356,0.668746
4604,1,4604,171243206,256059356,0.668764
4611,1,4611,171247817,256059356,0.668782
4616,1,4616,171252433,256059356,0.6688
4619,2,9238,171261671,256059356,0.668836
4622,2,9244,171270915,256059356,0.668872
4623,1,4623,171275538,256059356,0.66889
4624,1,4624,171280162,256059356,0.668908
4625,1,4625,171284787,256059356,0.668926
4626,2,9252,171294039,256059356,0.668962
4628,1,4628,171298667,256059356,0.66898
4636,1,4636,171303303,256059356,0.668998
4640,1,4640,171307943,256059356,0.669017
4642,1,4642,171312585,256059356,0.669035
4645,2,9290,171321875,256059356,0.669071
4646,1,4646,171326521,256059356,0.669089
4647,1,4647,171331168,256059356,0.669107
4650,1,4650,171335818,256059356,0.669125
4655,1,4655,171340473,256059356,0.669144
4656,1,4656,171345129,256059356,0.669162
4657,1,4657,171349786,256059356,0.66918
4658,1,4658,171354444,256059356,0.669198
4659,1,4659,171359103,256059356,0.669216
4663,1,4663,171363766,256059356,0.669235
4670,1,4670,171368436,256059356,0.669253
4675,1,4675,171373111,256059356,0.669271
4676,1,4676,171377787,256059356,0.669289
4677,2,9354,171387141,256059356,0.669326
4678,2,9356,171396497,256059356,0.669362
4679,2,9358,171405855,256059356,0.669399
4681,1,4681,171410536,256059356,0.669417
4686,2,9372,171419908,256059356,0.669454
4687,1,4687,171424595,256059356,0.669472
4688,2,9376,171433971,256059356,0.669509
4690,1,4690,171438661,256059356,0.669527
4691,1,4691,171443352,256059356,0.669545
4693,1,4693,171448045,256059356,0.669564
4694,2,9388,171457433,256059356,0.6696
4698,3,14094,171471527,256059356,0.669655
4701,1,4701,171476228,256059356,0.669674
4703,1,4703,171480931,256059356,0.669692
4708,1,4708,171485639,256059356,0.66971
4712,1,4712,171490351,256059356,0.669729
4716,2,9432,171499783,256059356,0.669766
4717,1,4717,171504500,256059356,0.669784
4718,1,4718,171509218,256059356,0.669803
4720,3,14160,171523378,256059356,0.669858
4722,2,9444,171532822,256059356,0.669895
4723,1,4723,171537545,256059356,0.669913
4727,1,4727,171542272,256059356,0.669932
4728,1,4728,171547000,256059356,0.66995
4735,1,4735,171551735,256059356,0.669969
4736,1,4736,171556471,256059356,0.669987
4743,3,14229,171570700,256059356,0.670043
4746,1,4746,171575446,256059356,0.670061
4748,1,4748,171580194,256059356,0.67008
4751,2,9502,171589696,256059356,0.670117
4752,3,14256,171603952,256059356,0.670173
4753,1,4753,171608705,256059356,0.670191
4757,2,9514,171618219,256059356,0.670228
4759,1,4759,171622978,256059356,0.670247
4761,2,9522,171632500,256059356,0.670284
4764,1,4764,171637264,256059356,0.670303
4767,1,4767,171642031,256059356,0.670321
4769,1,4769,171646800,256059356,0.67034
4770,2,9540,171656340,256059356,0.670377
4772,3,14316,171670656,256059356,0.670433
4778,1,4778,171675434,256059356,0.670452
4779,1,4779,171680213,256059356,0.67047
4785,1,4785,171684998,256059356,0.670489
4788,1,4788,171689786,256059356,0.670508
4792,1,4792,171694578,256059356,0.670526
4793,2,9586,171704164,256059356,0.670564
4798,1,4798,171708962,256059356,0.670583
4799,1,4799,171713761,256059356,0.670601
4802,2,9604,171723365,256059356,0.670639
4803,2,9606,171732971,256059356,0.670676
4804,1,4804,171737775,256059356,0.670695
4805,1,4805,171742580,256059356,0.670714
4807,1,4807,171747387,256059356,0.670733
4813,1,4813,171752200,256059356,0.670752
4814,1,4814,171757014,256059356,0.67077
4816,2,9632,171766646,256059356,0.670808
4818,2,9636,171776282,256059356,0.670846
4822,1,4822,171781104,256059356,0.670864
4826,1,4826,171785930,256059356,0.670883
4827,1,4827,171790757,256059356,0.670902
4829,2,9658,171800415,256059356,0.67094
4830,1,4830,171805245,256059356,0.670959
4831,1,4831,171810076,256059356,0.670978
4834,1,4834,171814910,256059356,0.670996
4836,1,4836,171819746,256059356,0.671015
4837,4,19348,171839094,256059356,0.671091
4840,1,4840,171843934,256059356,0.67111
4842,2,9684,171853618,256059356,0.671148
4843,1,4843,171858461,256059356,0.671166
4844,1,4844,171863305,256059356,0.671185
4845,4,19380,171882685,256059356,0.671261
4846,1,4846,171887531,256059356,0.67128
4848,1,4848,171892379,256059356,0.671299
4849,2,9698,171902077,256059356,0.671337
4850,2,9700,171911777,256059356,0.671375
4851,1,4851,171916628,256059356,0.671394
4853,1,4853,171921481,256059356,0.671413
4854,2,9708,171931189,256059356,0.671451
4855,2,9710,171940899,256059356,0.671488
4858,1,4858,171945757,256059356,0.671507
4863,1,4863,171950620,256059356,0.671526
4864,1,4864,171955484,256059356,0.671545
4865,1,4865,171960349,256059356,0.671564
4866,1,4866,171965215,256059356,0.671583
4868,1,4868,171970083,256059356,0.671602
4870,2,9740,171979823,256059356,0.67164
4873,3,14619,171994442,256059356,0.671698
4874,1,4874,171999316,256059356,0.671717
4882,1,4882,172004198,256059356,0.671736
4884,1,4884,172009082,256059356,0.671755
4885,1,4885,172013967,256059356,0.671774
4890,2,9780,172023747,256059356,0.671812
4891,2,9782,172033529,256059356,0.67185
4892,2,9784,172043313,256059356,0.671888
4894,4,19576,172062889,256059356,0.671965
4895,1,4895,172067784,256059356,0.671984
4898,1,4898,172072682,256059356,0.672003
4901,1,4901,172077583,256059356,0.672022
4902,1,4902,172082485,256059356,0.672041
4904,1,4904,172087389,256059356,0.672061
4907,1,4907,172092296,256059356,0.67208
4909,2,9818,172102114,256059356,0.672118
4911,1,4911,172107025,256059356,0.672137
4912,1,4912,172111937,256059356,0.672156
4916,2,9832,172121769,256059356,0.672195
4917,1,4917,172126686,256059356,0.672214
4919,3,14757,172141443,256059356,0.672272
4922,1,4922,172146365,256059356,0.672291
4923,1,4923,172151288,256059356,0.67231
4924,1,4924,172156212,256059356,0.672329
4927,1,4927,172161139,256059356,0.672349
4931,3,14793,172175932,256059356,0.672406
4935,2,9870,172185802,256059356,0.672445
4937,1,4937,172190739,256059356,0.672464
4939,1,4939,172195678,256059356,0.672483
4940,1,4940,172200618,256059356,0.672503
4941,1,4941,172205559,256059356,0.672522
4943,1,4943,172210502,256059356,0.672541
4948,1,4948,172215450,256059356,0.672561
4951,2,9902,172225352,256059356,0.672599
4953,1,4953,172230305,256059356,0.672619
4955,1,4955,172235260,256059356,0.672638
4956,1,4956,172240216,256059356,0.672657
4957,1,4957,172245173,256059356,0.672677
4962,1,4962,172250135,256059356,0.672696
4963,1,4963,172255098,256059356,0.672716
4967,1,4967,172260065,256059356,0.672735
4968,1,4968,172265033,256059356,0.672754
4970,1,4970,172270003,256059356,0.672774
4971,1,4971,172274974,256059356,0.672793
4972,1,4972,172279946,256059356,0.672813
4973,2,9946,172289892,256059356,0.672851
4974,1,4974,172294866,256059356,0.672871
4975,2,9950,172304816,256059356,0.67291
4979,3,14937,172319753,256059356,0.672968
4980,5,24900,172344653,256059356,0.673065
4981,2,9962,172354615,256059356,0.673104
4982,2,9964,172364579,256059356,0.673143
4984,2,9968,172374547,256059356,0.673182
4986,2,9972,172384519,256059356,0.673221
4987,1,4987,172389506,256059356,0.67324
4988,4,19952,172409458,256059356,0.673318
4989,3,14967,172424425,256059356,0.673377
4990,1,4990,172429415,256059356,0.673396
4991,1,4991,172434406,256059356,0.673416
4992,3,14976,172449382,256059356,0.673474
4993,2,9986,172459368,256059356,0.673513
5005,1,5005,172464373,256059356,0.673533
5006,2,10012,172474385,256059356,0.673572
5007,2,10014,172484399,256059356,0.673611
5009,2,10018,172494417,256059356,0.67365
5013,2,10026,172504443,256059356,0.673689
5016,1,5016,172509459,256059356,0.673709
5017,2,10034,172519493,256059356,0.673748
5019,1,5019,172524512,256059356,0.673768
5023,1,5023,172529535,256059356,0.673787
5024,2,10048,172539583,256059356,0.673827
5027,1,5027,172544610,256059356,0.673846
5028,1,5028,172549638,256059356,0.673866
5029,1,5029,172554667,256059356,0.673885
5030,2,10060,172564727,256059356,0.673925
5031,2,10062,172574789,256059356,0.673964
5034,1,5034,172579823,256059356,0.673984
5045,2,10090,172589913,256059356,0.674023
5047,1,5047,172594960,256059356,0.674043
5049,2,10098,172605058,256059356,0.674082
5050,4,20200,172625258,256059356,0.674161
5051,1,5051,172630309,256059356,0.674181
5052,5,25260,172655569,256059356,0.674279
5053,3,15159,172670728,256059356,0.674339
5054,1,5054,172675782,256059356,0.674358
5056,1,5056,172680838,256059356,0.674378
5057,3,15171,172696009,256059356,0.674437
5058,4,20232,172716241,256059356,0.674516
5059,1,5059,172721300,256059356,0.674536
5060,2,10120,172731420,256059356,0.674576
5061,2,10122,172741542,256059356,0.674615
5064,1,5064,172746606,256059356,0.674635
5065,1,5065,172751671,256059356,0.674655
5070,1,5070,172756741,256059356,0.674675
5071,1,5071,172761812,256059356,0.674694
5072,2,10144,172771956,256059356,0.674734
5074,1,5074,172777030,256059356,0.674754
5076,1,5076,172782106,256059356,0.674774
5080,1,5080,172787186,256059356,0.674793
5083,2,10166,172797352,256059356,0.674833
5084,1,5084,172802436,256059356,0.674853
5085,1,5085,172807521,256059356,0.674873
5087,2,10174,172817695,256059356,0.674913
5088,1,5088,172822783,256059356,0.674933
5089,1,5089,172827872,256059356,0.674952
5092,1,5092,172832964,256059356,0.674972
5094,2,10188,172843152,256059356,0.675012
5095,1,5095,172848247,256059356,0.675032
5096,1,5096,172853343,256059356,0.675052
5097,1,5097,172858440,256059356,0.675072
5099,1,5099,172863539,256059356,0.675092
5100,1,5100,172868639,256059356,0.675112
5103,1,5103,172873742,256059356,0.675132
5108,1,5108,172878850,256059356,0.675151
5109,1,5109,172883959,256059356,0.675171
5110,1,5110,172889069,256059356,0.675191
5114,1,5114,172894183,256059356,0.675211
5117,1,5117,172899300,256059356,0.675231
5118,3,15354,172914654,256059356,0.675291
5119,2,10238,172924892,256059356,0.675331
5121,1,5121,172930013,256059356,0.675351
5122,1,5122,172935135,256059356,0.675371
5125,1,5125,172940260,256059356,0.675391
5130,1,5130,172945390,256059356,0.675411
5134,2,10268,172955658,256059356,0.675451
5135,1,5135,172960793,256059356,0.675471
5138,1,5138,172965931,256059356,0.675492
5140,1,5140,172971071,256059356,0.675512
5142,1,5142,172976213,256059356,0.675532
5144,1,5144,172981357,256059356,0.675552
5145,2,10290,172991647,256059356,0.675592
5146,1,5146,172996793,256059356,0.675612
5148,5,25740,173022533,256059356,0.675713
5150,1,5150,173027683,256059356,0.675733
5152,2,10304,173037987,256059356,0.675773
5156,1,5156,173043143,256059356,0.675793
5157,1,5157,173048300,256059356,0.675813
5160,1,5160,173053460,256059356,0.675833
5162,2,10324,173063784,256059356,0.675874
5166,1,5166,173068950,256059356,0.675894
5167,1,5167,173074117,256059356,0.675914
5168,1,5168,173079285,256059356,0.675934
5169,1,5169,173084454,256059356,0.675954
5172,1,5172,173089626,256059356,0.675975
5175,1,5175,173094801,256059356,0.675995
5177,2,10354,173105155,256059356,0.676035
5178,1,5178,173110333,256059356,0.676055
5179,1,5179,173115512,256059356,0.676076
5185,1,5185,173120697,256059356,0.676096
5192,2,10384,173131081,256059356,0.676137
5194,2,10388,173141469,256059356,0.676177
5196,1,5196,173146665,256059356,0.676197
5197,1,5197,173151862,256059356,0.676218
5198,2,10396,173162258,256059356,0.676258
5200,1,5200,173167458,256059356,0.676279
5204,1,5204,173172662,256059356,0.676299
5207,1,5207,173177869,256059356,0.676319
5210,1,5210,173183079,256059356,0.67634
5211,1,5211,173188290,256059356,0.67636
5215,2,10430,173198720,256059356,0.676401
5217,1,5217,173203937,256059356,0.676421
5225,1,5225,173209162,256059356,0.676441
5228,2,10456,173219618,256059356,0.676482
5233,1,5233,173224851,256059356,0.676503
5238,1,5238,173230089,256059356,0.676523
5239,1,5239,173235328,256059356,0.676544
5240,2,10480,173245808,256059356,0.676585
5253,1,5253,173251061,256059356,0.676605
5255,1,5255,173256316,256059356,0.676626
5259,2,10518,173266834,256059356,0.676667
5261,1,5261,173272095,256059356,0.676687
5264,1,5264,173277359,256059356,0.676708
5265,1,5265,173282624,256059356,0.676728
5267,1,5267,173287891,256059356,0.676749
5270,1,5270,173293161,256059356,0.676769
5272,1,5272,173298433,256059356,0.67679
5275,1,5275,173303708,256059356,0.676811
5281,1,5281,173308989,256059356,0.676831
5282,1,5282,173314271,256059356,0.676852
5284,2,10568,173324839,256059356,0.676893
5285,1,5285,173330124,256059356,0.676914
5286,2,10572,173340696,256059356,0.676955
5291,1,5291,173345987,256059356,0.676976
5295,1,5295,173351282,256059356,0.676996
5297,1,5297,173356579,256059356,0.677017
5298,1,5298,173361877,256059356,0.677038
5302,1,5302,173367179,256059356,0.677059
5303,1,5303,173372482,256059356,0.677079
5305,2,10610,173383092,256059356,0.677121
5306,1,5306,173388398,256059356,0.677141
5309,1,5309,173393707,256059356,0.677162
5310,1,5310,173399017,256059356,0.677183
5314,1,5314,173404331,256059356,0.677204
5315,1,5315,173409646,256059356,0.677224
5316,1,5316,173414962,256059356,0.677245
5319,2,10638,173425600,256059356,0.677287
5321,1,5321,173430921,256059356,0.677307
5326,1,5326,173436247,256059356,0.677328
5328,1,5328,173441575,256059356,0.677349
5331,1,5331,173446906,256059356,0.67737
5335,1,5335,173452241,256059356,0.677391
5338,1,5338,173457579,256059356,0.677412
5342,1,5342,173462921,256059356,0.677432
5346,2,10692,173473613,256059356,0.677474
5347,1,5347,173478960,256059356,0.677495
5350,1,5350,173484310,256059356,0.677516
5352,1,5352,173489662,256059356,0.677537
5353,1,5353,173495015,256059356,0.677558
5354,1,5354,173500369,256059356,0.677579
5355,1,5355,173505724,256059356,0.6776
5356,1,5356,173511080,256059356,0.677621
5368,1,5368,173516448,256059356,0.677642
5369,1,5369,173521817,256059356,0.677662
5375,1,5375,173527192,256059356,0.677683
5378,1,5378,173532570,256059356,0.677704
5385,1,5385,173537955,256059356,0.677725
5386,1,5386,173543341,256059356,0.677747
5387,1,5387,173548728,256059356,0.677768
5388,2,10776,173559504,256059356,0.67781
5392,1,5392,173564896,256059356,0.677831
5397,1,5397,173570293,256059356,0.677852
5399,1,5399,173575692,256059356,0.677873
5405,2,10810,173586502,256059356,0.677915
5410,1,5410,173591912,256059356,0.677936
5414,1,5414,173597326,256059356,0.677957
5415,1,5415,173602741,256059356,0.677979
5420,1,5420,173608161,256059356,0.678
5425,1,5425,173613586,256059356,0.678021
5427,1,5427,173619013,256059356,0.678042
5432,1,5432,173624445,256059356,0.678063
5440,2,10880,173635325,256059356,0.678106
5444,1,5444,173640769,256059356,0.678127
5447,1,5447,173646216,256059356,0.678148
5450,1,5450,173651666,256059356,0.67817
5452,1,5452,173657118,256059356,0.678191
5453,1,5453,173662571,256059356,0.678212
5455,1,5455,173668026,256059356,0.678233
5459,1,5459,173673485,256059356,0.678255
5460,1,5460,173678945,256059356,0.678276
5463,1,5463,173684408,256059356,0.678297
5468,2,10936,173695344,256059356,0.67834
5470,1,5470,173700814,256059356,0.678362
5473,1,5473,173706287,256059356,0.678383
5478,1,5478,173711765,256059356,0.678404
5479,1,5479,173717244,256059356,0.678426
5483,1,5483,173722727,256059356,0.678447
5485,2,10970,173733697,256059356,0.67849
5497,1,5497,173739194,256059356,0.678511
5502,2,11004,173750198,256059356,0.678554
5503,1,5503,173755701,256059356,0.678576
5506,1,5506,173761207,256059356,0.678597
5508,1,5508,173766715,256059356,0.678619
5509,2,11018,173777733,256059356,0.678662
5513,1,5513,173783246,256059356,0.678683
5517,1,5517,173788763,256059356,0.678705
5518,1,5518,173794281,256059356,0.678727
5519,1,5519,173799800,256059356,0.678748
5520,1,5520,173805320,256059356,0.67877
5524,1,5524,173810844,256059356,0.678791
5529,1,5529,173816373,256059356,0.678813
5531,3,16593,173832966,256059356,0.678878
5535,1,5535,173838501,256059356,0.678899
5537,1,5537,173844038,256059356,0.678921
5538,1,5538,173849576,256059356,0.678942
5539,1,5539,173855115,256059356,0.678964
5550,1,5550,173860665,256059356,0.678986
5564,2,11128,173871793,256059356,0.679029
5566,1,5566,173877359,256059356,0.679051
5572,2,11144,173888503,256059356,0.679095
5576,1,5576,173894079,256059356,0.679116
5580,1,5580,173899659,256059356,0.679138
5581,1,5581,173905240,256059356,0.67916
5587,1,5587,173910827,256059356,0.679182
5592,1,5592,173916419,256059356,0.679204
5593,1,5593,173922012,256059356,0.679225
5596,1,5596,173927608,256059356,0.679247
5597,1,5597,173933205,256059356,0.679269
5605,2,11210,173944415,256059356,0.679313
5610,1,5610,173950025,256059356,0.679335
5612,1,5612,173955637,256059356,0.679357
5615,1,5615,173961252,256059356,0.679379
5621,1,5621,173966873,256059356,0.679401
5622,1,5622,173972495,256059356,0.679423
5623,1,5623,173978118,256059356,0.679444
5624,1,5624,173983742,256059356,0.679466
5625,1,5625,173989367,256059356,0.679488
5628,1,5628,173994995,256059356,0.67951
5629,1,5629,174000624,256059356,0.679532
5642,1,5642,174006266,256059356,0.679554
5645,1,5645,174011911,256059356,0.679576
5646,1,5646,174017557,256059356,0.679599
5649,1,5649,174023206,256059356,0.679621
5657,1,5657,174028863,256059356,0.679643
5659,1,5659,174034522,256059356,0.679665
5660,1,5660,174040182,256059356,0.679687
5663,3,16989,174057171,256059356,0.679753
5665,1,5665,174062836,256059356,0.679775
5666,2,11332,174074168,256059356,0.67982
5684,1,5684,174079852,256059356,0.679842
5687,1,5687,174085539,256059356,0.679864
5688,1,5688,174091227,256059356,0.679886
5689,1,5689,174096916,256059356,0.679908
5691,1,5691,174102607,256059356,0.679931
5694,1,5694,174108301,256059356,0.679953
5701,1,5701,174114002,256059356,0.679975
5703,1,5703,174119705,256059356,0.679997
5704,1,5704,174125409,256059356,0.68002
5706,1,5706,174131115,256059356,0.680042
5711,1,5711,174136826,256059356,0.680064
5717,1,5717,174142543,256059356,0.680087
5733,2,11466,174154009,256059356,0.680131
5738,1,5738,174159747,256059356,0.680154
5746,3,17238,174176985,256059356,0.680221
5748,1,5748,174182733,256059356,0.680244
5755,2,11510,174194243,256059356,0.680289
5759,1,5759,174200002,256059356,0.680311
5765,2,11530,174211532,256059356,0.680356
5769,1,5769,174217301,256059356,0.680379
5771,1,5771,174223072,256059356,0.680401
5773,1,5773,174228845,256059356,0.680424
5775,1,5775,174234620,256059356,0.680446
5777,1,5777,174240397,256059356,0.680469
5783,2,11566,174251963,256059356,0.680514
5785,1,5785,174257748,256059356,0.680537
5789,1,5789,174263537,256059356,0.680559
5799,1,5799,174269336,256059356,0.680582
5803,1,5803,174275139,256059356,0.680604
5804,2,11608,174286747,256059356,0.68065
5805,1,5805,174292552,256059356,0.680672
5810,1,5810,174298362,256059356,0.680695
5814,1,5814,174304176,256059356,0.680718
5815,2,11630,174315806,256059356,0.680763
5819,1,5819,174321625,256059356,0.680786
5821,1,5821,174327446,256059356,0.680809
5824,1,5824,174333270,256059356,0.680831
5828,2,11656,174344926,256059356,0.680877
5838,1,5838,174350764,256059356,0.6809
5840,1,5840,174356604,256059356,0.680923
5842,1,5842,174362446,256059356,0.680945
5846,1,5846,174368292,256059356,0.680968
5866,1,5866,174374158,256059356,0.680991
5868,1,5868,174380026,256059356,0.681014
5870,4,23480,174403506,256059356,0.681106
5871,1,5871,174409377,256059356,0.681129
5888,1,5888,174415265,256059356,0.681152
5897,1,5897,174421162,256059356,0.681175
5900,2,11800,174432962,256059356,0.681221
5902,1,5902,174438864,256059356,0.681244
5903,1,5903,174444767,256059356,0.681267
5904,1,5904,174450671,256059356,0.68129
5906,3,17718,174468389,256059356,0.681359
5909,1,5909,174474298,256059356,0.681382
5911,1,5911,174480209,256059356,0.681405
5916,1,5916,174486125,256059356,0.681428
5932,1,5932,174492057,256059356,0.681452
5946,1,5946,174498003,256059356,0.681475
5953,1,5953,174503956,256059356,0.681498
5958,2,11916,174515872,256059356,0.681545
5959,1,5959,174521831,256059356,0.681568
5961,1,5961,174527792,256059356,0.681591
5964,1,5964,174533756,256059356,0.681614
5970,1,5970,174539726,256059356,0.681638
5971,1,5971,174545697,256059356,0.681661
5975,1,5975,174551672,256059356,0.681684
5980,1,5980,174557652,256059356,0.681708
5985,1,5985,174563637,256059356,0.681731
5986,1,5986,174569623,256059356,0.681755
5989,1,5989,174575612,256059356,0.681778
5990,1,5990,174581602,256059356,0.681801
5995,1,5995,174587597,256059356,0.681825
5996,1,5996,174593593,256059356,0.681848
5998,1,5998,174599591,256059356,0.681872
6001,1,6001,174605592,256059356,0.681895
6002,1,6002,174611594,256059356,0.681918
6004,2,12008,174623602,256059356,0.681965
6007,1,6007,174629609,256059356,0.681989
6016,1,6016,174635625,256059356,0.682012
6017,1,6017,174641642,256059356,0.682036
6019,1,6019,174647661,256059356,0.682059
6020,1,6020,174653681,256059356,0.682083
6021,1,6021,174659702,256059356,0.682106
6025,1,6025,174665727,256059356,0.68213
6026,1,6026,174671753,256059356,0.682153
6028,1,6028,174677781,256059356,0.682177
6033,1,6033,174683814,256059356,0.6822
6037,1,6037,174689851,256059356,0.682224
6039,1,6039,174695890,256059356,0.682248
6047,2,12094,174707984,256059356,0.682295
6054,1,6054,174714038,256059356,0.682319
6068,1,6068,174720106,256059356,0.682342
6069,1,6069,174726175,256059356,0.682366
6070,2,12140,174738315,256059356,0.682413
6074,1,6074,174744389,256059356,0.682437
6088,3,18264,174762653,256059356,0.682508
6089,2,12178,174774831,256059356,0.682556
6090,1,6090,174780921,256059356,0.68258
6092,1,6092,174787013,256059356,0.682604
6097,1,6097,174793110,256059356,0.682627
6098,2,12196,174805306,256059356,0.682675
6099,1,6099,174811405,256059356,0.682699
6102,1,6102,174817507,256059356,0.682723
6106,1,6106,174823613,256059356,0.682746
6107,1,6107,174829720,256059356,0.68277
6109,1,6109,174835829,256059356,0.682794
6112,1,6112,174841941,256059356,0.682818
6116,1,6116,174848057,256059356,0.682842
6117,1,6117,174854174,256059356,0.682866
6118,1,6118,174860292,256059356,0.68289
6134,1,6134,174866426,256059356,0.682914
6137,1,6137,174872563,256059356,0.682938
6142,1,6142,174878705,256059356,0.682962
6147,1,6147,174884852,256059356,0.682986
6149,2,12298,174897150,256059356,0.683034
6150,1,6150,174903300,256059356,0.683058
6151,1,6151,174909451,256059356,0.683082
6153,1,6153,174915604,256059356,0.683106
6154,1,6154,174921758,256059356,0.68313
6167,1,6167,174927925,256059356,0.683154
6170,3,18510,174946435,256059356,0.683226
6171,2,12342,174958777,256059356,0.683274
6173,1,6173,174964950,256059356,0.683298
6174,1,6174,174971124,256059356,0.683323
6181,1,6181,174977305,256059356,0.683347
6182,2,12364,174989669,256059356,0.683395
6183,2,12366,175002035,256059356,0.683443
6185,1,6185,175008220,256059356,0.683467
6186,1,6186,175014406,256059356,0.683492
6187,1,6187,175020593,256059356,0.683516
6189,1,6189,175026782,256059356,0.68354
6191,1,6191,175032973,256059356,0.683564
6196,2,12392,175045365,256059356,0.683612
6198,2,12396,175057761,256059356,0.683661
6199,1,6199,175063960,256059356,0.683685
6208,2,12416,175076376,256059356,0.683734
6210,1,6210,175082586,256059356,0.683758
6211,1,6211,175088797,256059356,0.683782
6212,2,12424,175101221,256059356,0.683831
6213,1,6213,175107434,256059356,0.683855
6218,1,6218,175113652,256059356,0.683879
6220,1,6220,175119872,256059356,0.683903
6221,1,6221,175126093,256059356,0.683928
6225,1,6225,175132318,256059356,0.683952
6226,1,6226,175138544,256059356,0.683976
6228,1,6228,175144772,256059356,0.684001
6229,3,18687,175163459,256059356,0.684074
6233,1,6233,175169692,256059356,0.684098
6236,1,6236,175175928,256059356,0.684122
6242,1,6242,175182170,256059356,0.684147
6243,2,12486,175194656,256059356,0.684195
6249,2,12498,175207154,256059356,0.684244
6251,1,6251,175213405,256059356,0.684269
6253,2,12506,175225911,256059356,0.684318
6255,1,6255,175232166,256059356,0.684342
6263,2,12526,175244692,256059356,0.684391
6266,1,6266,175250958,256059356,0.684415
6280,1,6280,175257238,256059356,0.68444
6290,1,6290,175263528,256059356,0.684464
6295,1,6295,175269823,256059356,0.684489
6298,1,6298,175276121,256059356,0.684514
6307,1,6307,175282428,256059356,0.684538
6312,4,25248,175307676,256059356,0.684637
6329,1,6329,175314005,256059356,0.684662
6334,1,6334,175320339,256059356,0.684686
6337,1,6337,175326676,256059356,0.684711
6340,1,6340,175333016,256059356,0.684736
6347,1,6347,175339363,256059356,0.684761
6353,1,6353,175345716,256059356,0.684785
6355,1,6355,175352071,256059356,0.68481
6360,1,6360,175358431,256059356,0.684835
6365,1,6365,175364796,256059356,0.68486
6372,1,6372,175371168,256059356,0.684885
6376,1,6376,175377544,256059356,0.68491
6386,1,6386,175383930,256059356,0.684935
6392,1,6392,175390322,256059356,0.68496
6395,2,12790,175403112,256059356,0.68501
6398,1,6398,175409510,256059356,0.685035
6407,1,6407,175415917,256059356,0.68506
6408,2,12816,175428733,256059356,0.68511
6409,1,6409,175435142,256059356,0.685135
6416,1,6416,175441558,256059356,0.68516
6417,1,6417,175447975,256059356,0.685185
6418,1,6418,175454393,256059356,0.68521
6424,1,6424,175460817,256059356,0.685235
6425,1,6425,175467242,256059356,0.68526
6426,1,6426,175473668,256059356,0.685285
6432,1,6432,175480100,256059356,0.68531
6433,1,6433,175486533,256059356,0.685335
6443,1,6443,175492976,256059356,0.685361
6444,2,12888,175505864,256059356,0.685411
6445,1,6445,175512309,256059356,0.685436
6447,2,12894,175525203,256059356,0.685486
6452,1,6452,175531655,256059356,0.685512
6457,1,6457,175538112,256059356,0.685537
6462,2,12924,175551036,256059356,0.685587
6468,1,6468,175557504,256059356,0.685613
6474,1,6474,175563978,256059356,0.685638
6475,1,6475,175570453,256059356,0.685663
6479,1,6479,175576932,256059356,0.685688
6480,1,6480,175583412,256059356,0.685714
6481,1,6481,175589893,256059356,0.685739
6488,1,6488,175596381,256059356,0.685764
6489,1,6489,175602870,256059356,0.68579
6494,1,6494,175609364,256059356,0.685815
6498,1,6498,175615862,256059356,0.68584
6501,2,13002,175628864,256059356,0.685891
6503,1,6503,175635367,256059356,0.685917
6505,2,13010,175648377,256059356,0.685967
6507,1,6507,175654884,256059356,0.685993
6511,1,6511,175661395,256059356,0.686018
6515,1,6515,175667910,256059356,0.686044
6516,1,6516,175674426,256059356,0.686069
6520,1,6520,175680946,256059356,0.686095
6521,1,6521,175687467,256059356,0.68612
6523,1,6523,175693990,256059356,0.686146
6524,2,13048,175707038,256059356,0.686197
6527,1,6527,175713565,256059356,0.686222
6528,1,6528,175720093,256059356,0.686248
6533,1,6533,175726626,256059356,0.686273
6535,1,6535,175733161,256059356,0.686299
6546,1,6546,175739707,256059356,0.686324
6547,1,6547,175746254,256059356,0.68635
6553,1,6553,175752807,256059356,0.686375
6557,1,6557,175759364,256059356,0.686401
6570,1,6570,175765934,256059356,0.686427
6578,4,26312,175792246,256059356,0.686529
6580,1,6580,175798826,256059356,0.686555
6586,1,6586,175805412,256059356,0.686581
6592,1,6592,175812004,256059356,0.686606
6601,1,6601,175818605,256059356,0.686632
6604,1,6604,175825209,256059356,0.686658
6605,1,6605,175831814,256059356,0.686684
6606,1,6606,175838420,256059356,0.68671
6607,1,6607,175845027,256059356,0.686735
6613,1,6613,175851640,256059356,0.686761
6618,1,6618,175858258,256059356,0.686787
6622,1,6622,175864880,256059356,0.686813
6637,1,6637,175871517,256059356,0.686839
6639,1,6639,175878156,256059356,0.686865
6640,1,6640,175884796,256059356,0.686891
6642,2,13284,175898080,256059356,0.686943
6644,1,6644,175904724,256059356,0.686969
6648,2,13296,175918020,256059356,0.68702
6649,1,6649,175924669,256059356,0.687046
6675,1,6675,175931344,256059356,0.687073
6676,2,13352,175944696,256059356,0.687125
6680,1,6680,175951376,256059356,0.687151
6681,1,6681,175958057,256059356,0.687177
6688,1,6688,175964745,256059356,0.687203
6690,1,6690,175971435,256059356,0.687229
6693,2,13386,175984821,256059356,0.687281
6696,1,6696,175991517,256059356,0.687308
6704,1,6704,175998221,256059356,0.687334
6709,1,6709,176004930,256059356,0.68736
6720,1,6720,176011650,256059356,0.687386
6722,1,6722,176018372,256059356,0.687412
6723,1,6723,176025095,256059356,0.687439
6725,1,6725,176031820,256059356,0.687465
6729,1,6729,176038549,256059356,0.687491
6730,2,13460,176052009,256059356,0.687544
6731,1,6731,176058740,256059356,0.68757
6732,1,6732,176065472,256059356,0.687596
6735,1,6735,176072207,256059356,0.687623
6738,1,6738,176078945,256059356,0.687649
6741,2,13482,176092427,256059356,0.687702
6751,2,13502,176105929,256059356,0.687754
6755,2,13510,176119439,256059356,0.687807
6764,3,20292,176139731,256059356,0.687886
6766,1,6766,176146497,256059356,0.687913
6767,2,13534,176160031,256059356,0.687966
6777,1,6777,176166808,256059356,0.687992
6790,1,6790,176173598,256059356,0.688019
6792,4,27168,176200766,256059356,0.688125
6793,2,13586,176214352,256059356,0.688178
6804,2,13608,176227960,256059356,0.688231
6815,1,6815,176234775,256059356,0.688258
6827,1,6827,176241602,256059356,0.688284
6829,1,6829,176248431,256059356,0.688311
6831,2,13662,176262093,256059356,0.688364
6833,1,6833,176268926,256059356,0.688391
6835,1,6835,176275761,256059356,0.688418
6836,1,6836,176282597,256059356,0.688444
6838,1,6838,176289435,256059356,0.688471
6852,1,6852,176296287,256059356,0.688498
6853,1,6853,176303140,256059356,0.688524
6859,3,20577,176323717,256059356,0.688605
6864,1,6864,176330581,256059356,0.688632
6871,1,6871,176337452,256059356,0.688658
6875,1,6875,176344327,256059356,0.688685
6876,1,6876,176351203,256059356,0.688712
6878,1,6878,176358081,256059356,0.688739
6879,1,6879,176364960,256059356,0.688766
6891,1,6891,176371851,256059356,0.688793
6892,1,6892,176378743,256059356,0.68882
6894,1,6894,176385637,256059356,0.688847
6897,1,6897,176392534,256059356,0.688874
6900,1,6900,176399434,256059356,0.688901
6903,1,6903,176406337,256059356,0.688928
6910,1,6910,176413247,256059356,0.688955
6927,1,6927,176420174,256059356,0.688982
6928,1,6928,176427102,256059356,0.689009
6932,1,6932,176434034,256059356,0.689036
6939,1,6939,176440973,256059356,0.689063
6942,2,13884,176454857,256059356,0.689117
6943,2,13886,176468743,256059356,0.689171
6946,2,13892,176482635,256059356,0.689225
6956,1,6956,176489591,256059356,0.689253
6971,1,6971,176496562,256059356,0.68928
6979,2,13958,176510520,256059356,0.689334
6988,1,6988,176517508,256059356,0.689362
6989,1,6989,176524497,256059356,0.689389
6993,1,6993,176531490,256059356,0.689416
6998,2,13996,176545486,256059356,0.689471
6999,1,6999,176552485,256059356,0.689498
7001,1,7001,176559486,256059356,0.689526
7005,1,7005,176566491,256059356,0.689553
7009,2,14018,176580509,256059356,0.689608
7012,1,7012,176587521,256059356,0.689635
7016,1,7016,176594537,256059356,0.689663
7019,1,7019,176601556,256059356,0.68969
7021,1,7021,176608577,256059356,0.689717
7023,1,7023,176615600,256059356,0.689745
7042,1,7042,176622642,256059356,0.689772
7044,2,14088,176636730,256059356,0.689827
7046,2,14092,176650822,256059356,0.689882
7048,1,7048,176657870,256059356,0.68991
7051,1,7051,176664921,256059356,0.689937
7052,1,7052,176671973,256059356,0.689965
7056,1,7056,176679029,256059356,0.689992
7062,1,7062,176686091,256059356,0.69002
7067,1,7067,176693158,256059356,0.690048
7069,1,7069,176700227,256059356,0.690075
7075,1,7075,176707302,256059356,0.690103
7080,1,7080,176714382,256059356,0.690131
7085,1,7085,176721467,256059356,0.690158
7089,1,7089,176728556,256059356,0.690186
7092,1,7092,176735648,256059356,0.690214
7096,2,14192,176749840,256059356,0.690269
7097,1,7097,176756937,256059356,0.690297
7101,2,14202,176771139,256059356,0.690352
7105,1,7105,176778244,256059356,0.69038
7106,1,7106,176785350,256059356,0.690408
7110,1,7110,176792460,256059356,0.690435
7117,1,7117,176799577,256059356,0.690463
7118,1,7118,176806695,256059356,0.690491
7121,1,7121,176813816,256059356,0.690519
7124,2,14248,176828064,256059356,0.690575
7127,1,7127,176835191,256059356,0.690602
7133,1,7133,176842324,256059356,0.69063
7136,1,7136,176849460,256059356,0.690658
7138,1,7138,176856598,256059356,0.690686
7139,1,7139,176863737,256059356,0.690714
7142,1,7142,176870879,256059356,0.690742
7143,3,21429,176892308,256059356,0.690825
7151,1,7151,176899459,256059356,0.690853
7152,1,7152,176906611,256059356,0.690881
7158,1,7158,176913769,256059356,0.690909
7160,1,7160,176920929,256059356,0.690937
7166,1,7166,176928095,256059356,0.690965
7173,2,14346,176942441,256059356,0.691021
7176,1,7176,176949617,256059356,0.691049
7184,1,7184,176956801,256059356,0.691077
7185,1,7185,176963986,256059356,0.691105
7186,1,7186,176971172,256059356,0.691133
7190,1,7190,176978362,256059356,0.691161
7195,1,7195,176985557,256059356,0.69119
7200,2,14400,176999957,256059356,0.691246
7202,1,7202,177007159,256059356,0.691274
7203,3,21609,177028768,256059356,0.691358
7204,1,7204,177035972,256059356,0.691386
7209,1,7209,177043181,256059356,0.691415
7210,2,14420,177057601,256059356,0.691471
7214,1,7214,177064815,256059356,0.691499
7219,2,14438,177079253,256059356,0.691555
7223,1,7223,177086476,256059356,0.691584
7226,2,14452,177100928,256059356,0.69164
7228,1,7228,177108156,256059356,0.691668
7231,1,7231,177115387,256059356,0.691697
7236,1,7236,177122623,256059356,0.691725
7249,1,7249,177129872,256059356,0.691753
7250,1,7250,177137122,256059356,0.691781
7252,1,7252,177144374,256059356,0.69181
7262,1,7262,177151636,256059356,0.691838
7263,1,7263,177158899,256059356,0.691867
7270,1,7270,177166169,256059356,0.691895
7278,1,7278,177173447,256059356,0.691923
7287,1,7287,177180734,256059356,0.691952
7292,1,7292,177188026,256059356,0.69198
7300,1,7300,177195326,256059356,0.692009
7308,1,7308,177202634,256059356,0.692037
7312,1,7312,177209946,256059356,0.692066
7315,2,14630,177224576,256059356,0.692123
7316,1,7316,177231892,256059356,0.692152
7319,1,7319,177239211,256059356,0.69218
7322,1,7322,177246533,256059356,0.692209
7331,1,7331,177253864,256059356,0.692237
7332,1,7332,177261196,256059356,0.692266
7334,2,14668,177275864,256059356,0.692323
7335,1,7335,177283199,256059356,0.692352
7336,1,7336,177290535,256059356,0.692381
7338,1,7338,177297873,256059356,0.692409
7341,1,7341,177305214,256059356,0.692438
7344,1,7344,177312558,256059356,0.692467
7345,1,7345,177319903,256059356,0.692495
7351,1,7351,177327254,256059356,0.692524
7374,1,7374,177334628,256059356,0.692553
7380,1,7380,177342008,256059356,0.692582
7385,1,7385,177349393,256059356,0.69261
7389,1,7389,177356782,256059356,0.692639
7391,1,7391,177364173,256059356,0.692668
7393,1,7393,177371566,256059356,0.692697
7394,1,7394,177378960,256059356,0.692726
7405,1,7405,177386365,256059356,0.692755
7406,1,7406,177393771,256059356,0.692784
7408,1,7408,177401179,256059356,0.692813
7413,1,7413,177408592,256059356,0.692842
7416,2,14832,177423424,256059356,0.6929
7431,1,7431,177430855,256059356,0.692929
7432,1,7432,177438287,256059356,0.692958
7438,1,7438,177445725,256059356,0.692987
7441,1,7441,177453166,256059356,0.693016
7442,1,7442,177460608,256059356,0.693045
7445,1,7445,177468053,256059356,0.693074
7457,1,7457,177475510,256059356,0.693103
7468,1,7468,177482978,256059356,0.693132
7488,1,7488,177490466,256059356,0.693161
7494,1,7494,177497960,256059356,0.693191
7498,1,7498,177505458,256059356,0.69322
7500,10,75000,177580458,256059356,0.693513
7503,1,7503,177587961,256059356,0.693542
7507,1,7507,177595468,256059356,0.693571
7512,1,7512,177602980,256059356,0.693601
7516,2,15032,177618012,256059356,0.69366
7517,1,7517,177625529,256059356,0.693689
7519,1,7519,177633048,256059356,0.693718
7523,1,7523,177640571,256059356,0.693748
7524,1,7524,177648095,256059356,0.693777
7528,1,7528,177655623,256059356,0.693806
7533,1,7533,177663156,256059356,0.693836
7535,1,7535,177670691,256059356,0.693865
7537,1,7537,177678228,256059356,0.693895
7539,3,22617,177700845,256059356,0.693983
7540,4,30160,177731005,256059356,0.694101
7541,2,15082,177746087,256059356,0.69416
7542,2,15084,177761171,256059356,0.694219
7544,1,7544,177768715,256059356,0.694248
7545,1,7545,177776260,256059356,0.694278
7546,1,7546,177783806,256059356,0.694307
7549,1,7549,177791355,256059356,0.694336
7550,1,7550,177798905,256059356,0.694366
7551,1,7551,177806456,256059356,0.694395
7552,1,7552,177814008,256059356,0.694425
7555,1,7555,177821563,256059356,0.694454
7556,1,7556,177829119,256059356,0.694484
7558,1,7558,177836677,256059356,0.694513
7559,2,15118,177851795,256059356,0.694573
7563,2,15126,177866921,256059356,0.694632
7564,1,7564,177874485,256059356,0.694661
7566,1,7566,177882051,256059356,0.694691
7568,4,30272,177912323,256059356,0.694809
7569,7,52983,177965306,256059356,0.695016
7570,7,52990,178018296,256059356,0.695223
7580,1,7580,178025876,256059356,0.695252
7585,1,7585,178033461,256059356,0.695282
7586,1,7586,178041047,256059356,0.695312
7589,1,7589,178048636,256059356,0.695341
7594,1,7594,178056230,256059356,0.695371
7596,1,7596,178063826,256059356,0.695401
7597,1,7597,178071423,256059356,0.69543
7605,1,7605,178079028,256059356,0.69546
7613,1,7613,178086641,256059356,0.69549
7632,1,7632,178094273,256059356,0.695519
7643,1,7643,178101916,256059356,0.695549
7668,1,7668,178109584,256059356,0.695579
7669,1,7669,178117253,256059356,0.695609
7670,3,23010,178140263,256059356,0.695699
7671,1,7671,178147934,256059356,0.695729
7673,1,7673,178155607,256059356,0.695759
7675,1,7675,178163282,256059356,0.695789
7678,1,7678,178170960,256059356,0.695819
7681,1,7681,178178641,256059356,0.695849
7682,1,7682,178186323,256059356,0.695879
7689,1,7689,178194012,256059356,0.695909
7691,1,7691,178201703,256059356,0.695939
7693,1,7693,178209396,256059356,0.695969
7697,1,7697,178217093,256059356,0.695999
7700,1,7700,178224793,256059356,0.696029
7704,1,7704,178232497,256059356,0.696059
7713,1,7713,178240210,256059356,0.696089
7728,1,7728,178247938,256059356,0.69612
7732,1,7732,178255670,256059356,0.69615
7742,1,7742,178263412,256059356,0.69618
7748,1,7748,178271160,256059356,0.69621
7749,1,7749,178278909,256059356,0.696241
7761,1,7761,178286670,256059356,0.696271
7766,1,7766,178294436,256059356,0.696301
7792,2,15584,178310020,256059356,0.696362
7804,2,15608,178325628,256059356,0.696423
7810,1,7810,178333438,256059356,0.696454
7814,1,7814,178341252,256059356,0.696484
7820,2,15640,178356892,256059356,0.696545
7826,1,7826,178364718,256059356,0.696576
7835,1,7835,178372553,256059356,0.696606
7837,1,7837,178380390,256059356,0.696637
7838,1,7838,178388228,256059356,0.696667
7844,1,7844,178396072,256059356,0.696698
7846,1,7846,178403918,256059356,0.696729
7849,3,23547,178427465,256059356,0.696821
7852,1,7852,178435317,256059356,0.696851
7856,1,7856,178443173,256059356,0.696882
7858,1,7858,178451031,256059356,0.696913
7878,1,7878,178458909,256059356,0.696944
7881,1,7881,178466790,256059356,0.696974
7884,1,7884,178474674,256059356,0.697005
7894,2,15788,178490462,256059356,0.697067
7900,1,7900,178498362,256059356,0.697098
7902,1,7902,178506264,256059356,0.697128
7929,1,7929,178514193,256059356,0.697159
7934,1,7934,178522127,256059356,0.69719
7937,1,7937,178530064,256059356,0.697221
7945,1,7945,178538009,256059356,0.697252
7946,1,7946,178545955,256059356,0.697283
7948,1,7948,178553903,256059356,0.697315
7951,1,7951,178561854,256059356,0.697346
7953,1,7953,178569807,256059356,0.697377
7957,2,15914,178585721,256059356,0.697439
7962,1,7962,178593683,256059356,0.69747
7982,1,7982,178601665,256059356,0.697501
7994,1,7994,178609659,256059356,0.697532
7999,1,7999,178617658,256059356,0.697563
8011,2,16022,178633680,256059356,0.697626
8013,1,8013,178641693,256059356,0.697657
8014,1,8014,178649707,256059356,0.697689
8019,1,8019,178657726,256059356,0.69772
8031,1,8031,178665757,256059356,0.697751
8034,1,8034,178673791,256059356,0.697783
8041,1,8041,178681832,256059356,0.697814
8042,1,8042,178689874,256059356,0.697846
8048,2,16096,178705970,256059356,0.697908
8064,1,8064,178714034,256059356,0.69794
8069,2,16138,178730172,256059356,0.698003
8074,2,16148,178746320,256059356,0.698066
8097,1,8097,178754417,256059356,0.698098
8100,1,8100,178762517,256059356,0.698129
8101,2,16202,178778719,256059356,0.698192
8113,1,8113,178786832,256059356,0.698224
8117,2,16234,178803066,256059356,0.698288
8122,1,8122,178811188,256059356,0.698319
8126,1,8126,178819314,256059356,0.698351
8135,1,8135,178827449,256059356,0.698383
8162,1,8162,178835611,256059356,0.698415
8167,1,8167,178843778,256059356,0.698447
8174,1,8174,178851952,256059356,0.698478
8176,1,8176,178860128,256059356,0.69851
8179,1,8179,178868307,256059356,0.698542
8219,1,8219,178876526,256059356,0.698574
8220,1,8220,178884746,256059356,0.698607
8230,1,8230,178892976,256059356,0.698639
8237,1,8237,178901213,256059356,0.698671
8248,1,8248,178909461,256059356,0.698703
8257,1,8257,178917718,256059356,0.698735
8262,2,16524,178934242,256059356,0.6988
8270,1,8270,178942512,256059356,0.698832
8272,2,16544,178959056,256059356,0.698897
8286,1,8286,178967342,256059356,0.698929
8293,1,8293,178975635,256059356,0.698962
8295,1,8295,178983930,256059356,0.698994
8303,1,8303,178992233,256059356,0.699026
8305,1,8305,179000538,256059356,0.699059
8312,1,8312,179008850,256059356,0.699091
8314,1,8314,179017164,256059356,0.699124
8315,1,8315,179025479,256059356,0.699156
8318,1,8318,179033797,256059356,0.699189
8325,1,8325,179042122,256059356,0.699221
8326,2,16652,179058774,256059356,0.699286
8330,1,8330,179067104,256059356,0.699319
8360,1,8360,179075464,256059356,0.699351
8370,1,8370,179083834,256059356,0.699384
8411,2,16822,179100656,256059356,0.69945
8412,1,8412,179109068,256059356,0.699483
8415,1,8415,179117483,256059356,0.699515
8423,1,8423,179125906,256059356,0.699548
8457,1,8457,179134363,256059356,0.699581
8458,1,8458,179142821,256059356,0.699614
8473,1,8473,179151294,256059356,0.699648
8474,1,8474,179159768,256059356,0.699681
8477,1,8477,179168245,256059356,0.699714
8481,1,8481,179176726,256059356,0.699747
8485,1,8485,179185211,256059356,0.69978
8489,1,8489,179193700,256059356,0.699813
8492,1,8492,179202192,256059356,0.699846
8499,11,93489,179295681,256059356,0.700211
8500,3,25500,179321181,256059356,0.700311
8504,1,8504,179329685,256059356,0.700344
8508,1,8508,179338193,256059356,0.700377
8518,1,8518,179346711,256059356,0.700411
8522,1,8522,179355233,256059356,0.700444
8526,1,8526,179363759,256059356,0.700477
8548,1,8548,179372307,256059356,0.700511
8554,1,8554,179380861,256059356,0.700544
8556,1,8556,179389417,256059356,0.700577
8574,2,17148,179406565,256059356,0.700644
8594,1,8594,179415159,256059356,0.700678
8596,1,8596,179423755,256059356,0.700712
8610,1,8610,179432365,256059356,0.700745
8614,1,8614,179440979,256059356,0.700779
8622,1,8622,179449601,256059356,0.700813
8644,1,8644,179458245,256059356,0.700846
8648,1,8648,179466893,256059356,0.70088
8660,2,17320,179484213,256059356,0.700948
8662,1,8662,179492875,256059356,0.700982
8663,1,8663,179501538,256059356,0.701015
8669,1,8669,179510207,256059356,0.701049
8687,1,8687,179518894,256059356,0.701083
8701,1,8701,179527595,256059356,0.701117
8721,2,17442,179545037,256059356,0.701185
8725,1,8725,179553762,256059356,0.701219
8737,1,8737,179562499,256059356,0.701253
8739,1,8739,179571238,256059356,0.701288
8742,1,8742,179579980,256059356,0.701322
8748,1,8748,179588728,256059356,0.701356
8753,1,8753,179597481,256059356,0.70139
8756,1,8756,179606237,256059356,0.701424
8763,1,8763,179615000,256059356,0.701458
8767,1,8767,179623767,256059356,0.701493
8773,1,8773,179632540,256059356,0.701527
8785,1,8785,179641325,256059356,0.701561
8800,1,8800,179650125,256059356,0.701596
8806,1,8806,179658931,256059356,0.70163
8808,1,8808,179667739,256059356,0.701664
8811,1,8811,179676550,256059356,0.701699
8816,1,8816,179685366,256059356,0.701733
8821,1,8821,179694187,256059356,0.701768
8823,1,8823,179703010,256059356,0.701802
8833,1,8833,179711843,256059356,0.701837
8841,1,8841,179720684,256059356,0.701871
8842,1,8842,179729526,256059356,0.701906
8852,1,8852,179738378,256059356,0.70194
8865,1,8865,179747243,256059356,0.701975
8869,1,8869,179756112,256059356,0.70201
8870,1,8870,179764982,256059356,0.702044
8874,1,8874,179773856,256059356,0.702079
8887,1,8887,179782743,256059356,0.702114
8891,1,8891,179791634,256059356,0.702148
8894,1,8894,179800528,256059356,0.702183
8897,1,8897,179809425,256059356,0.702218
8898,2,17796,179827221,256059356,0.702287
8909,1,8909,179836130,256059356,0.702322
8928,1,8928,179845058,256059356,0.702357
8932,1,8932,179853990,256059356,0.702392
8933,1,8933,179862923,256059356,0.702427
8934,1,8934,179871857,256059356,0.702462
8937,1,8937,179880794,256059356,0.702496
8941,1,8941,179889735,256059356,0.702531
8945,1,8945,179898680,256059356,0.702566
8948,2,17896,179916576,256059356,0.702636
8950,1,8950,179925526,256059356,0.702671
8955,1,8955,179934481,256059356,0.702706
8958,1,8958,179943439,256059356,0.702741
8960,1,8960,179952399,256059356,0.702776
8980,1,8980,179961379,256059356,0.702811
8984,1,8984,179970363,256059356,0.702846
8986,1,8986,179979349,256059356,0.702881
8988,1,8988,179988337,256059356,0.702916
8998,1,8998,179997335,256059356,0.702952
9005,1,9005,180006340,256059356,0.702987
9010,1,9010,180015350,256059356,0.703022
9013,1,9013,180024363,256059356,0.703057
9025,1,9025,180033388,256059356,0.703092
9035,1,9035,180042423,256059356,0.703128
9047,1,9047,180051470,256059356,0.703163
9055,2,18110,180069580,256059356,0.703234
9068,1,9068,180078648,256059356,0.703269
9077,1,9077,180087725,256059356,0.703305
9079,1,9079,180096804,256059356,0.70334
9081,1,9081,180105885,256059356,0.703376
9101,1,9101,180114986,256059356,0.703411
9122,1,9122,180124108,256059356,0.703447
9126,1,9126,180133234,256059356,0.703482
9128,1,9128,180142362,256059356,0.703518
9130,1,9130,180151492,256059356,0.703554
9134,2,18268,180169760,256059356,0.703625
9137,1,9137,180178897,256059356,0.703661
9148,1,9148,180188045,256059356,0.703696
9149,8,73192,180261237,256059356,0.703982
9151,1,9151,180270388,256059356,0.704018
9154,1,9154,180279542,256059356,0.704054
9155,1,9155,180288697,256059356,0.704089
9161,1,9161,180297858,256059356,0.704125
9176,1,9176,180307034,256059356,0.704161
9183,1,9183,180316217,256059356,0.704197
9184,1,9184,180325401,256059356,0.704233
9189,1,9189,180334590,256059356,0.704269
9192,1,9192,180343782,256059356,0.704305
9197,1,9197,180352979,256059356,0.704341
9200,1,9200,180362179,256059356,0.704376
9215,1,9215,180371394,256059356,0.704412
9222,1,9222,180380616,256059356,0.704448
9224,1,9224,180389840,256059356,0.704484
9231,1,9231,180399071,256059356,0.704521
9234,2,18468,180417539,256059356,0.704593
9235,1,9235,180426774,256059356,0.704629
9240,1,9240,180436014,256059356,0.704665
9247,1,9247,180445261,256059356,0.704701
9257,1,9257,180454518,256059356,0.704737
9262,1,9262,180463780,256059356,0.704773
9265,1,9265,180473045,256059356,0.704809
9285,1,9285,180482330,256059356,0.704846
9292,1,9292,180491622,256059356,0.704882
9299,1,9299,180500921,256059356,0.704918
9330,1,9330,180510251,256059356,0.704955
9335,1,9335,180519586,256059356,0.704991
9336,1,9336,180528922,256059356,0.705028
9345,1,9345,180538267,256059356,0.705064
9362,2,18724,180556991,256059356,0.705137
9365,1,9365,180566356,256059356,0.705174
9367,1,9367,180575723,256059356,0.70521
9369,1,9369,180585092,256059356,0.705247
9392,1,9392,180594484,256059356,0.705284
9402,2,18804,180613288,256059356,0.705357
9405,1,9405,180622693,256059356,0.705394
9409,1,9409,180632102,256059356,0.705431
9417,2,18834,180650936,256059356,0.705504
9428,1,9428,180660364,256059356,0.705541
9435,3,28305,180688669,256059356,0.705652
9439,1,9439,180698108,256059356,0.705688
9442,1,9442,180707550,256059356,0.705725
9449,1,9449,180716999,256059356,0.705762
9459,1,9459,180726458,256059356,0.705799
9474,2,18948,180745406,256059356,0.705873
9482,1,9482,180754888,256059356,0.70591
9483,2,18966,180773854,256059356,0.705984
9488,1,9488,180783342,256059356,0.706021
9492,1,9492,180792834,256059356,0.706058
9508,1,9508,180802342,256059356,0.706095
9511,1,9511,180811853,256059356,0.706133
9525,1,9525,180821378,256059356,0.70617
9544,2,19088,180840466,256059356,0.706244
9550,1,9550,180850016,256059356,0.706282
9555,1,9555,180859571,256059356,0.706319
9560,1,9560,180869131,256059356,0.706356
9567,1,9567,180878698,256059356,0.706394
9573,1,9573,180888271,256059356,0.706431
9585,2,19170,180907441,256059356,0.706506
9589,1,9589,180917030,256059356,0.706543
9590,1,9590,180926620,256059356,0.706581
9591,1,9591,180936211,256059356,0.706618
9592,1,9592,180945803,256059356,0.706656
9594,1,9594,180955397,256059356,0.706693
9596,1,9596,180964993,256059356,0.706731
9602,1,9602,180974595,256059356,0.706768
9606,1,9606,180984201,256059356,0.706806
9610,1,9610,180993811,256059356,0.706843
9611,1,9611,181003422,256059356,0.706881
9613,1,9613,181013035,256059356,0.706918
9615,1,9615,181022650,256059356,0.706956
9621,1,9621,181032271,256059356,0.706993
9634,1,9634,181041905,256059356,0.707031
9635,1,9635,181051540,256059356,0.707069
9645,1,9645,181061185,256059356,0.707106
9651,1,9651,181070836,256059356,0.707144
9653,1,9653,181080489,256059356,0.707182
9656,1,9656,181090145,256059356,0.707219
9672,1,9672,181099817,256059356,0.707257
9678,1,9678,181109495,256059356,0.707295
9679,1,9679,181119174,256059356,0.707333
9686,2,19372,181138546,256059356,0.707408
9688,2,19376,181157922,256059356,0.707484
9693,1,9693,181167615,256059356,0.707522
9698,1,9698,181177313,256059356,0.70756
9700,1,9700,181187013,256059356,0.707598
9702,1,9702,181196715,256059356,0.707636
9708,1,9708,181206423,256059356,0.707674
9709,2,19418,181225841,256059356,0.707749
9710,4,38840,181264681,256059356,0.707901
9711,1,9711,181274392,256059356,0.707939
9712,1,9712,181284104,256059356,0.707977
9713,2,19426,181303530,256059356,0.708053
9714,1,9714,181313244,256059356,0.708091
9718,2,19436,181332680,256059356,0.708167
9719,1,9719,181342399,256059356,0.708205
9721,2,19442,181361841,256059356,0.70828
9723,1,9723,181371564,256059356,0.708318
9730,1,9730,181381294,256059356,0.708356
9734,2,19468,181400762,256059356,0.708432
9738,1,9738,181410500,256059356,0.708471
9745,2,19490,181429990,256059356,0.708547
9771,1,9771,181439761,256059356,0.708585
9777,1,9777,181449538,256059356,0.708623
9787,1,9787,181459325,256059356,0.708661
9795,1,9795,181469120,256059356,0.708699
9797,1,9797,181478917,256059356,0.708738
9814,1,9814,181488731,256059356,0.708776
9815,1,9815,181498546,256059356,0.708814
9816,1,9816,181508362,256059356,0.708853
9823,1,9823,181518185,256059356,0.708891
9824,1,9824,181528009,256059356,0.708929
9830,1,9830,181537839,256059356,0.708968
9832,1,9832,181547671,256059356,0.709006
9842,1,9842,181557513,256059356,0.709045
9844,1,9844,181567357,256059356,0.709083
9848,1,9848,181577205,256059356,0.709122
9853,1,9853,181587058,256059356,0.70916
9856,1,9856,181596914,256059356,0.709199
9858,2,19716,181616630,256059356,0.709276
9860,1,9860,181626490,256059356,0.709314
9869,1,9869,181636359,256059356,0.709353
9871,1,9871,181646230,256059356,0.709391
9875,1,9875,181656105,256059356,0.70943
9876,1,9876,181665981,256059356,0.709468
9880,1,9880,181675861,256059356,0.709507
9881,3,29643,181705504,256059356,0.709623
9882,1,9882,181715386,256059356,0.709661
9886,1,9886,181725272,256059356,0.7097
9909,1,9909,181735181,256059356,0.709738
9910,2,19820,181755001,256059356,0.709816
9917,1,9917,181764918,256059356,0.709855
9919,1,9919,181774837,256059356,0.709893
9924,1,9924,181784761,256059356,0.709932
9926,1,9926,181794687,256059356,0.709971
9936,1,9936,181804623,256059356,0.71001
9939,1,9939,181814562,256059356,0.710049
9943,2,19886,181834448,256059356,0.710126
9952,1,9952,181844400,256059356,0.710165
9953,2,19906,181864306,256059356,0.710243
9955,2,19910,181884216,256059356,0.710321
9958,1,9958,181894174,256059356,0.710359
9964,1,9964,181904138,256059356,0.710398
9967,1,9967,181914105,256059356,0.710437
9970,1,9970,181924075,256059356,0.710476
9980,10,99800,182023875,256059356,0.710866
9981,4,39924,182063799,256059356,0.711022
9982,6,59892,182123691,256059356,0.711256
9983,9,89847,182213538,256059356,0.711607
9984,3,29952,182243490,256059356,0.711724
9985,2,19970,182263460,256059356,0.711802
9986,3,29958,182293418,256059356,0.711919
9987,3,29961,182323379,256059356,0.712036
9988,1,9988,182333367,256059356,0.712075
9989,2,19978,182353345,256059356,0.712153
9990,3,29970,182383315,256059356,0.71227
9991,3,29973,182413288,256059356,0.712387
9993,2,19986,182433274,256059356,0.712465
9995,2,19990,182453264,256059356,0.712543
9998,4,39992,182493256,256059356,0.712699
9999,9,89991,182583247,256059356,0.71305
10000,3,30000,182613247,256059356,0.713168
10001,5,50005,182663252,256059356,0.713363
10002,9,90018,182753270,256059356,0.713714
10003,1,10003,182763273,256059356,0.713754
10004,1,10004,182773277,256059356,0.713793
10005,7,70035,182843312,256059356,0.714066
10006,2,20012,182863324,256059356,0.714144
10007,2,20014,182883338,256059356,0.714222
10008,3,30024,182913362,256059356,0.71434
10009,10,100090,183013452,256059356,0.714731
10010,2,20020,183033472,256059356,0.714809
10012,1,10012,183043484,256059356,0.714848
10013,3,30039,183073523,256059356,0.714965
10014,2,20028,183093551,256059356,0.715043
10015,4,40060,183133611,256059356,0.7152
10017,5,50085,183183696,256059356,0.715395
10018,1,10018,183193714,256059356,0.715435
10020,5,50100,183243814,256059356,0.71563
10021,3,30063,183273877,256059356,0.715748
10022,4,40088,183313965,256059356,0.715904
10023,3,30069,183344034,256059356,0.716022
10024,2,20048,183364082,256059356,0.7161
10025,1,10025,183374107,256059356,0.716139
10027,3,30081,183404188,256059356,0.716257
10028,2,20056,183424244,256059356,0.716335
10030,1,10030,183434274,256059356,0.716374
10031,1,10031,183444305,256059356,0.716413
10034,2,20068,183464373,256059356,0.716492
10035,1,10035,183474408,256059356,0.716531
10036,1,10036,183484444,256059356,0.71657
10037,1,10037,183494481,256059356,0.716609
10038,1,10038,183504519,256059356,0.716648
10040,2,20080,183524599,256059356,0.716727
10041,2,20082,183544681,256059356,0.716805
10042,1,10042,183554723,256059356,0.716844
10044,1,10044,183564767,256059356,0.716884
10045,1,10045,183574812,256059356,0.716923
10047,2,20094,183594906,256059356,0.717001
10050,1,10050,183604956,256059356,0.717041
10054,1,10054,183615010,256059356,0.71708
10055,2,20110,183635120,256059356,0.717158
10056,1,10056,183645176,256059356,0.717198
10059,2,20118,183665294,256059356,0.717276
10067,1,10067,183675361,256059356,0.717316
10068,1,10068,183685429,256059356,0.717355
10073,2,20146,183705575,256059356,0.717434
10075,2,20150,183725725,256059356,0.717512
10076,1,10076,183735801,256059356,0.717552
10079,1,10079,183745880,256059356,0.717591
10083,1,10083,183755963,256059356,0.71763
10088,1,10088,183766051,256059356,0.71767
10089,1,10089,183776140,256059356,0.717709
10090,1,10090,183786230,256059356,0.717749
10092,1,10092,183796322,256059356,0.717788
10093,1,10093,183806415,256059356,0.717827
10095,1,10095,183816510,256059356,0.717867
10096,3,30288,183846798,256059356,0.717985
10101,2,20202,183867000,256059356,0.718064
10103,1,10103,183877103,256059356,0.718103
10106,1,10106,183887209,256059356,0.718143
10110,1,10110,183897319,256059356,0.718182
10112,2,20224,183917543,256059356,0.718261
10114,2,20228,183937771,256059356,0.71834
10117,1,10117,183947888,256059356,0.71838
10118,1,10118,183958006,256059356,0.718419
10124,1,10124,183968130,256059356,0.718459
10126,1,10126,183978256,256059356,0.718498
10127,2,20254,183998510,256059356,0.718578
10129,3,30387,184028897,256059356,0.718696
10130,1,10130,184039027,256059356,0.718736
10140,1,10140,184049167,256059356,0.718775
10143,1,10143,184059310,256059356,0.718815
10148,1,10148,184069458,256059356,0.718855
10152,1,10152,184079610,256059356,0.718894
10159,1,10159,184089769,256059356,0.718934
10160,1,10160,184099929,256059356,0.718974
10162,1,10162,184110091,256059356,0.719013
10169,1,10169,184120260,256059356,0.719053
10170,1,10170,184130430,256059356,0.719093
10176,1,10176,184140606,256059356,0.719133
10184,1,10184,184150790,256059356,0.719172
10189,1,10189,184160979,256059356,0.719212
10198,1,10198,184171177,256059356,0.719252
10200,1,10200,184181377,256059356,0.719292
10211,1,10211,184191588,256059356,0.719332
10212,1,10212,184201800,256059356,0.719371
10218,1,10218,184212018,256059356,0.719411
10225,2,20450,184232468,256059356,0.719491
10228,1,10228,184242696,256059356,0.719531
10229,1,10229,184252925,256059356,0.719571
10237,1,10237,184263162,256059356,0.719611
10245,1,10245,184273407,256059356,0.719651
10249,1,10249,184283656,256059356,0.719691
10250,1,10250,184293906,256059356,0.719731
10252,1,10252,184304158,256059356,0.719771
10257,1,10257,184314415,256059356,0.719811
10261,1,10261,184324676,256059356,0.719851
10267,1,10267,184334943,256059356,0.719891
10275,1,10275,184345218,256059356,0.719932
10276,1,10276,184355494,256059356,0.719972
10279,2,20558,184376052,256059356,0.720052
10288,1,10288,184386340,256059356,0.720092
10301,1,10301,184396641,256059356,0.720132
10312,1,10312,184406953,256059356,0.720173
10329,1,10329,184417282,256059356,0.720213
10347,1,10347,184427629,256059356,0.720253
10355,1,10355,184437984,256059356,0.720294
10368,1,10368,184448352,256059356,0.720334
10397,1,10397,184458749,256059356,0.720375
10404,1,10404,184469153,256059356,0.720416
10410,2,20820,184489973,256059356,0.720497
10416,1,10416,184500389,256059356,0.720538
10417,1,10417,184510806,256059356,0.720578
10430,1,10430,184521236,256059356,0.720619
10460,1,10460,184531696,256059356,0.72066
10462,1,10462,184542158,256059356,0.720701
10464,1,10464,184552622,256059356,0.720742
10468,1,10468,184563090,256059356,0.720782
10484,1,10484,184573574,256059356,0.720823
10516,1,10516,184584090,256059356,0.720864
10532,1,10532,184594622,256059356,0.720906
10533,1,10533,184605155,256059356,0.720947
10558,1,10558,184615713,256059356,0.720988
10568,1,10568,184626281,256059356,0.721029
10570,1,10570,184636851,256059356,0.721071
10581,1,10581,184647432,256059356,0.721112
10589,1,10589,184658021,256059356,0.721153
10594,2,21188,184679209,256059356,0.721236
10611,1,10611,184689820,256059356,0.721277
10613,2,21226,184711046,256059356,0.72136
10623,1,10623,184721669,256059356,0.721402
10630,1,10630,184732299,256059356,0.721443
10632,1,10632,184742931,256059356,0.721485
10635,1,10635,184753566,256059356,0.721526
10647,1,10647,184764213,256059356,0.721568
10659,1,10659,184774872,256059356,0.72161
10661,1,10661,184785533,256059356,0.721651
10667,1,10667,184796200,256059356,0.721693
10679,1,10679,184806879,256059356,0.721735
10703,1,10703,184817582,256059356,0.721776
10720,2,21440,184839022,256059356,0.72186
10724,1,10724,184849746,256059356,0.721902
10747,1,10747,184860493,256059356,0.721944
10750,2,21500,184881993,256059356,0.722028
10755,1,10755,184892748,256059356,0.72207
10761,1,10761,184903509,256059356,0.722112
10765,1,10765,184914274,256059356,0.722154
10768,1,10768,184925042,256059356,0.722196
10774,1,10774,184935816,256059356,0.722238
10778,1,10778,184946594,256059356,0.72228
10783,1,10783,184957377,256059356,0.722322
10784,1,10784,184968161,256059356,0.722364
10787,2,21574,184989735,256059356,0.722449
10788,1,10788,185000523,256059356,0.722491
10810,1,10810,185011333,256059356,0.722533
10811,1,10811,185022144,256059356,0.722575
10830,1,10830,185032974,256059356,0.722618
10851,1,10851,185043825,256059356,0.72266
10861,1,10861,185054686,256059356,0.722702
10883,1,10883,185065569,256059356,0.722745
10898,1,10898,185076467,256059356,0.722787
10913,1,10913,185087380,256059356,0.72283
10915,1,10915,185098295,256059356,0.722873
10918,4,43672,185141967,256059356,0.723043
10920,1,10920,185152887,256059356,0.723086
10961,1,10961,185163848,256059356,0.723129
10964,2,21928,185185776,256059356,0.723214
10971,4,43884,185229660,256059356,0.723386
10982,1,10982,185240642,256059356,0.723429
10996,1,10996,185251638,256059356,0.723471
11004,1,11004,185262642,256059356,0.723514
11008,1,11008,185273650,256059356,0.723557
11022,1,11022,185284672,256059356,0.7236
11040,1,11040,185295712,256059356,0.723644
11060,1,11060,185306772,256059356,0.723687
11072,1,11072,185317844,256059356,0.72373
11076,1,11076,185328920,256059356,0.723773
11104,2,22208,185351128,256059356,0.72386
11108,1,11108,185362236,256059356,0.723903
11110,1,11110,185373346,256059356,0.723947
11126,2,22252,185395598,256059356,0.724034
11128,1,11128,185406726,256059356,0.724077
11133,1,11133,185417859,256059356,0.724121
11144,1,11144,185429003,256059356,0.724164
11191,2,22382,185451385,256059356,0.724252
11235,1,11235,185462620,256059356,0.724295
11237,2,22474,185485094,256059356,0.724383
11242,1,11242,185496336,256059356,0.724427
11254,2,22508,185518844,256059356,0.724515
11266,1,11266,185530110,256059356,0.724559
11292,1,11292,185541402,256059356,0.724603
11297,1,11297,185552699,256059356,0.724647
11342,1,11342,185564041,256059356,0.724692
11352,1,11352,185575393,256059356,0.724736
11357,1,11357,185586750,256059356,0.72478
11373,1,11373,185598123,256059356,0.724825
11404,1,11404,185609527,256059356,0.724869
11419,1,11419,185620946,256059356,0.724914
11437,1,11437,185632383,256059356,0.724958
11444,2,22888,185655271,256059356,0.725048
11448,1,11448,185666719,256059356,0.725093
11450,1,11450,185678169,256059356,0.725137
11459,1,11459,185689628,256059356,0.725182
11481,1,11481,185701109,256059356,0.725227
11482,1,11482,185712591,256059356,0.725272
11502,1,11502,185724093,256059356,0.725317
11523,1,11523,185735616,256059356,0.725362
11526,1,11526,185747142,256059356,0.725407
11553,1,11553,185758695,256059356,0.725452
11582,1,11582,185770277,256059356,0.725497
11631,1,11631,185781908,256059356,0.725542
11643,1,11643,185793551,256059356,0.725588
11645,1,11645,185805196,256059356,0.725633
11659,1,11659,185816855,256059356,0.725679
11669,1,11669,185828524,256059356,0.725724
11670,1,11670,185840194,256059356,0.72577
11684,1,11684,185851878,256059356,0.725816
11692,1,11692,185863570,256059356,0.725861
11717,2,23434,185887004,256059356,0.725953
11742,2,23484,185910488,256059356,0.726045
11759,1,11759,185922247,256059356,0.72609
11763,1,11763,185934010,256059356,0.726136
11804,1,11804,185945814,256059356,0.726182
11826,1,11826,185957640,256059356,0.726229
11849,1,11849,185969489,256059356,0.726275
11852,1,11852,185981341,256059356,0.726321
11853,1,11853,185993194,256059356,0.726367
11868,1,11868,186005062,256059356,0.726414
11886,1,11886,186016948,256059356,0.72646
11921,1,11921,186028869,256059356,0.726507
11945,1,11945,186040814,256059356,0.726553
11966,1,11966,186052780,256059356,0.7266
11996,1,11996,186064776,256059356,0.726647
12014,1,12014,186076790,256059356,0.726694
12065,1,12065,186088855,256059356,0.726741
12097,1,12097,186100952,256059356,0.726788
12165,1,12165,186113117,256059356,0.726836
12167,1,12167,186125284,256059356,0.726883
12172,1,12172,186137456,256059356,0.726931
12183,1,12183,186149639,256059356,0.726978
12211,1,12211,186161850,256059356,0.727026
12232,1,12232,186174082,256059356,0.727074
12260,1,12260,186186342,256059356,0.727122
12264,1,12264,186198606,256059356,0.72717
12286,1,12286,186210892,256059356,0.727218
12306,1,12306,186223198,256059356,0.727266
12320,1,12320,186235518,256059356,0.727314
12332,1,12332,186247850,256059356,0.727362
12333,1,12333,186260183,256059356,0.72741
12335,1,12335,186272518,256059356,0.727458
12345,1,12345,186284863,256059356,0.727507
12346,1,12346,186297209,256059356,0.727555
12365,1,12365,186309574,256059356,0.727603
12385,1,12385,186321959,256059356,0.727651
12411,1,12411,186334370,256059356,0.7277
12415,1,12415,186346785,256059356,0.727748
12426,1,12426,186359211,256059356,0.727797
12478,1,12478,186371689,256059356,0.727846
12511,1,12511,186384200,256059356,0.727895
12532,1,12532,186396732,256059356,0.727943
12593,12,151116,186547848,256059356,0.728534
12594,1,12594,186560442,256059356,0.728583
12595,1,12595,186573037,256059356,0.728632
12610,1,12610,186585647,256059356,0.728681
12621,1,12621,186598268,256059356,0.728731
12662,1,12662,186610930,256059356,0.72878
12665,1,12665,186623595,256059356,0.728829
12731,1,12731,186636326,256059356,0.728879
12762,1,12762,186649088,256059356,0.728929
12764,1,12764,186661852,256059356,0.728979
12791,1,12791,186674643,256059356,0.729029
12800,1,12800,186687443,256059356,0.729079
12817,1,12817,186700260,256059356,0.729129
12841,1,12841,186713101,256059356,0.729179
12843,1,12843,186725944,256059356,0.729229
12864,1,12864,186738808,256059356,0.729279
12906,3,38718,186777526,256059356,0.729431
12953,1,12953,186790479,256059356,0.729481
12969,1,12969,186803448,256059356,0.729532
13012,1,13012,186816460,256059356,0.729583
13032,1,13032,186829492,256059356,0.729634
13064,1,13064,186842556,256059356,0.729685
13122,1,13122,186855678,256059356,0.729736
13124,1,13124,186868802,256059356,0.729787
13150,1,13150,186881952,256059356,0.729838
13154,1,13154,186895106,256059356,0.72989
13210,1,13210,186908316,256059356,0.729941
13219,1,13219,186921535,256059356,0.729993
13228,1,13228,186934763,256059356,0.730045
13231,1,13231,186947994,256059356,0.730096
13246,1,13246,186961240,256059356,0.730148
13251,1,13251,186974491,256059356,0.7302
13263,1,13263,186987754,256059356,0.730252
13281,1,13281,187001035,256059356,0.730303
13317,1,13317,187014352,256059356,0.730355
13327,1,13327,187027679,256059356,0.730408
13331,1,13331,187041010,256059356,0.73046
13337,1,13337,187054347,256059356,0.730512
13352,3,40056,187094403,256059356,0.730668
13361,1,13361,187107764,256059356,0.73072
13368,1,13368,187121132,256059356,0.730772
13405,1,13405,187134537,256059356,0.730825
13455,1,13455,187147992,256059356,0.730877
13568,1,13568,187161560,256059356,0.73093
13590,1,13590,187175150,256059356,0.730983
13604,1,13604,187188754,256059356,0.731037
13620,1,13620,187202374,256059356,0.73109
13628,1,13628,187216002,256059356,0.731143
13631,1,13631,187229633,256059356,0.731196
13644,1,13644,187243277,256059356,0.73125
13677,1,13677,187256954,256059356,0.731303
13705,1,13705,187270659,256059356,0.731356
13707,1,13707,187284366,256059356,0.73141
13734,1,13734,187298100,256059356,0.731464
13742,1,13742,187311842,256059356,0.731517
13762,2,27524,187339366,256059356,0.731625
13763,2,27526,187366892,256059356,0.731732
13767,2,27534,187394426,256059356,0.73184
13809,1,13809,187408235,256059356,0.731894
13840,1,13840,187422075,256059356,0.731948
13849,1,13849,187435924,256059356,0.732002
13854,1,13854,187449778,256059356,0.732056
13882,1,13882,187463660,256059356,0.73211
13934,1,13934,187477594,256059356,0.732165
13938,1,13938,187491532,256059356,0.732219
13964,1,13964,187505496,256059356,0.732274
14038,1,14038,187519534,256059356,0.732328
14050,1,14050,187533584,256059356,0.732383
14135,1,14135,187547719,256059356,0.732438
14188,2,28376,187576095,256059356,0.732549
14239,1,14239,187590334,256059356,0.732605
14264,1,14264,187604598,256059356,0.732661
14334,1,14334,187618932,256059356,0.732717
14336,1,14336,187633268,256059356,0.732773
14350,1,14350,187647618,256059356,0.732829
14382,1,14382,187662000,256059356,0.732885
14432,1,14432,187676432,256059356,0.732941
14434,1,14434,187690866,256059356,0.732997
14452,1,14452,187705318,256059356,0.733054
14464,1,14464,187719782,256059356,0.73311
14473,1,14473,187734255,256059356,0.733167
14484,1,14484,187748739,256059356,0.733224
14567,1,14567,187763306,256059356,0.73328
14583,1,14583,187777889,256059356,0.733337
14589,1,14589,187792478,256059356,0.733394
14591,1,14591,187807069,256059356,0.733451
14596,1,14596,187821665,256059356,0.733508
14609,1,14609,187836274,256059356,0.733565
14620,1,14620,187850894,256059356,0.733622
14665,3,43995,187894889,256059356,0.733794
14687,1,14687,187909576,256059356,0.733852
14693,1,14693,187924269,256059356,0.733909
14707,1,14707,187938976,256059356,0.733966
14730,1,14730,187953706,256059356,0.734024
14732,1,14732,187968438,256059356,0.734082
14737,1,14737,187983175,256059356,0.734139
14758,1,14758,187997933,256059356,0.734197
14883,1,14883,188012816,256059356,0.734255
14886,1,14886,188027702,256059356,0.734313
14895,1,14895,188042597,256059356,0.734371
14896,1,14896,188057493,256059356,0.734429
14921,1,14921,188072414,256059356,0.734488
14997,1,14997,188087411,256059356,0.734546
15004,1,15004,188102415,256059356,0.734605
15132,1,15132,188117547,256059356,0.734664
15212,1,15212,188132759,256059356,0.734723
15274,1,15274,188148033,256059356,0.734783
15279,1,15279,188163312,256059356,0.734843
15301,1,15301,188178613,256059356,0.734902
15303,1,15303,188193916,256059356,0.734962
15330,1,15330,188209246,256059356,0.735022
15338,1,15338,188224584,256059356,0.735082
15345,1,15345,188239929,256059356,0.735142
15405,1,15405,188255334,256059356,0.735202
15524,1,15524,188270858,256059356,0.735263
15559,1,15559,188286417,256059356,0.735323
15615,1,15615,188302032,256059356,0.735384
15633,1,15633,188317665,256059356,0.735445
15653,1,15653,188333318,256059356,0.735506
15675,1,15675,188348993,256059356,0.735568
15700,1,15700,188364693,256059356,0.735629
15740,1,15740,188380433,256059356,0.73569
15783,24,378792,188759225,256059356,0.73717
15789,2,31578,188790803,256059356,0.737293
15791,1,15791,188806594,256059356,0.737355
15795,1,15795,188822389,256059356,0.737416
15840,1,15840,188838229,256059356,0.737478
15852,1,15852,188854081,256059356,0.73754
15953,1,15953,188870034,256059356,0.737603
15955,1,15955,188885989,256059356,0.737665
15981,1,15981,188901970,256059356,0.737727
16102,1,16102,188918072,256059356,0.73779
16150,2,32300,188950372,256059356,0.737916
16172,2,32344,188982716,256059356,0.738043
16184,1,16184,188998900,256059356,0.738106
16212,1,16212,189015112,256059356,0.738169
16226,1,16226,189031338,256059356,0.738232
16228,1,16228,189047566,256059356,0.738296
16247,2,32494,189080060,256059356,0.738423
16279,1,16279,189096339,256059356,0.738486
16321,1,16321,189112660,256059356,0.73855
16371,1,16371,189129031,256059356,0.738614
16410,1,16410,189145441,256059356,0.738678
16488,1,16488,189161929,256059356,0.738743
16574,1,16574,189178503,256059356,0.738807
16674,1,16674,189195177,256059356,0.738872
16718,1,16718,189211895,256059356,0.738938
16743,1,16743,189228638,256059356,0.739003
16771,1,16771,189245409,256059356,0.739069
16941,1,16941,189262350,256059356,0.739135
16954,1,16954,189279304,256059356,0.739201
16985,1,16985,189296289,256059356,0.739267
16989,1,16989,189313278,256059356,0.739334
17100,1,17100,189330378,256059356,0.7394
17106,1,17106,189347484,256059356,0.739467
17115,1,17115,189364599,256059356,0.739534
17124,1,17124,189381723,256059356,0.739601
17127,1,17127,189398850,256059356,0.739668
17191,1,17191,189416041,256059356,0.739735
17224,1,17224,189433265,256059356,0.739802
17370,1,17370,189450635,256059356,0.73987
17390,1,17390,189468025,256059356,0.739938
17438,1,17438,189485463,256059356,0.740006
17469,2,34938,189520401,256059356,0.740142
17500,1,17500,189537901,256059356,0.740211
17526,1,17526,189555427,256059356,0.740279
17528,1,17528,189572955,256059356,0.740348
17655,1,17655,189590610,256059356,0.740417
17878,1,17878,189608488,256059356,0.740486
17879,3,53637,189662125,256059356,0.740696
17898,1,17898,189680023,256059356,0.740766
17908,1,17908,189697931,256059356,0.740836
17926,1,17926,189715857,256059356,0.740906
17932,1,17932,189733789,256059356,0.740976
17939,1,17939,189751728,256059356,0.741046
17962,1,17962,189769690,256059356,0.741116
18005,1,18005,189787695,256059356,0.741186
18056,1,18056,189805751,256059356,0.741257
18109,1,18109,189823860,256059356,0.741328
18147,1,18147,189842007,256059356,0.741398
18158,1,18158,189860165,256059356,0.741469
18187,1,18187,189878352,256059356,0.74154
18194,1,18194,189896546,256059356,0.741611
18444,1,18444,189914990,256059356,0.741683
18452,1,18452,189933442,256059356,0.741756
18453,1,18453,189951895,256059356,0.741828
18458,1,18458,189970353,256059356,0.7419
18505,1,18505,189988858,256059356,0.741972
18541,1,18541,190007399,256059356,0.742044
18549,1,18549,190025948,256059356,0.742117
18571,1,18571,190044519,256059356,0.742189
18605,1,18605,190063124,256059356,0.742262
18635,1,18635,190081759,256059356,0.742335
18640,1,18640,190100399,256059356,0.742408
18671,1,18671,190119070,256059356,0.74248
18703,1,18703,190137773,256059356,0.742554
18784,1,18784,190156557,256059356,0.742627
18785,1,18785,190175342,256059356,0.7427
18915,1,18915,190194257,256059356,0.742774
18965,1,18965,190213222,256059356,0.742848
18991,1,18991,190232213,256059356,0.742922
18995,1,18995,190251208,256059356,0.742997
19013,1,19013,190270221,256059356,0.743071
19103,1,19103,190289324,256059356,0.743145
19216,1,19216,190308540,256059356,0.74322
19227,1,19227,190327767,256059356,0.743295
19311,1,19311,190347078,256059356,0.743371
19368,1,19368,190366446,256059356,0.743447
19393,1,19393,190385839,256059356,0.743522
19394,1,19394,190405233,256059356,0.743598
19552,1,19552,190424785,256059356,0.743674
19580,1,19580,190444365,256059356,0.743751
19581,1,19581,190463946,256059356,0.743827
19669,2,39338,190503284,256059356,0.743981
19672,1,19672,190522956,256059356,0.744058
19701,1,19701,190542657,256059356,0.744135
19729,2,39458,190582115,256059356,0.744289
19733,1,19733,190601848,256059356,0.744366
19756,1,19756,190621604,256059356,0.744443
19799,1,19799,190641403,256059356,0.74452
19848,1,19848,190661251,256059356,0.744598
19868,1,19868,190681119,256059356,0.744675
19931,1,19931,190701050,256059356,0.744753
19943,1,19943,190720993,256059356,0.744831
19979,1,19979,190740972,256059356,0.744909
19981,1,19981,190760953,256059356,0.744987
19993,1,19993,190780946,256059356,0.745065
20010,1,20010,190800956,256059356,0.745143
20024,1,20024,190820980,256059356,0.745222
20033,1,20033,190841013,256059356,0.7453
20056,1,20056,190861069,256059356,0.745378
20210,1,20210,190881279,256059356,0.745457
20216,1,20216,190901495,256059356,0.745536
20237,1,20237,190921732,256059356,0.745615
20247,1,20247,190941979,256059356,0.745694
20248,1,20248,190962227,256059356,0.745773
20284,1,20284,190982511,256059356,0.745853
20312,1,20312,191002823,256059356,0.745932
20353,1,20353,191023176,256059356,0.746011
20438,1,20438,191043614,256059356,0.746091
20572,1,20572,191064186,256059356,0.746171
20633,1,20633,191084819,256059356,0.746252
20714,1,20714,191105533,256059356,0.746333
20739,1,20739,191126272,256059356,0.746414
20742,1,20742,191147014,256059356,0.746495
20743,1,20743,191167757,256059356,0.746576
20744,1,20744,191188501,256059356,0.746657
20751,1,20751,191209252,256059356,0.746738
20763,1,20763,191230015,256059356,0.746819
20806,1,20806,191250821,256059356,0.7469
20849,1,20849,191271670,256059356,0.746982
20855,1,20855,191292525,256059356,0.747063
20867,1,20867,191313392,256059356,0.747145
21154,1,21154,191334546,256059356,0.747227
21161,1,21161,191355707,256059356,0.74731
21244,1,21244,191376951,256059356,0.747393
21280,1,21280,191398231,256059356,0.747476
21314,1,21314,191419545,256059356,0.747559
21323,1,21323,191440868,256059356,0.747643
21334,1,21334,191462202,256059356,0.747726
21349,1,21349,191483551,256059356,0.747809
21367,1,21367,191504918,256059356,0.747893
21428,1,21428,191526346,256059356,0.747976
21448,2,42896,191569242,256059356,0.748144
21499,1,21499,191590741,256059356,0.748228
21528,1,21528,191612269,256059356,0.748312
21540,1,21540,191633809,256059356,0.748396
21576,1,21576,191655385,256059356,0.74848
21585,1,21585,191676970,256059356,0.748565
21646,1,21646,191698616,256059356,0.748649
21672,1,21672,191720288,256059356,0.748734
21766,1,21766,191742054,256059356,0.748819
21817,1,21817,191763871,256059356,0.748904
21818,1,21818,191785689,256059356,0.748989
21832,1,21832,191807521,256059356,0.749074
21863,1,21863,191829384,256059356,0.74916
21932,1,21932,191851316,256059356,0.749245
22081,1,22081,191873397,256059356,0.749332
22102,1,22102,191895499,256059356,0.749418
22123,1,22123,191917622,256059356,0.749504
22190,1,22190,191939812,256059356,0.749591
22219,1,22219,191962031,256059356,0.749678
22235,1,22235,191984266,256059356,0.749765
22399,1,22399,192006665,256059356,0.749852
22600,1,22600,192029265,256059356,0.74994
22606,3,67818,192097083,256059356,0.750205
22698,1,22698,192119781,256059356,0.750294
22763,1,22763,192142544,256059356,0.750383
22793,1,22793,192165337,256059356,0.750472
22957,1,22957,192188294,256059356,0.750561
23015,1,23015,192211309,256059356,0.750651
23024,1,23024,192234333,256059356,0.750741
23151,1,23151,192257484,256059356,0.750832
23339,1,23339,192280823,256059356,0.750923
23475,1,23475,192304298,256059356,0.751015
23512,2,47024,192351322,256059356,0.751198
23554,1,23554,192374876,256059356,0.75129
23628,1,23628,192398504,256059356,0.751382
23630,1,23630,192422134,256059356,0.751475
23750,1,23750,192445884,256059356,0.751567
23777,1,23777,192469661,256059356,0.75166
23879,2,47758,192517419,256059356,0.751847
23927,1,23927,192541346,256059356,0.75194
23943,1,23943,192565289,256059356,0.752034
24005,1,24005,192589294,256059356,0.752128
24012,1,24012,192613306,256059356,0.752221
24015,1,24015,192637321,256059356,0.752315
24039,1,24039,192661360,256059356,0.752409
24118,2,48236,192709596,256059356,0.752597
24224,1,24224,192733820,256059356,0.752692
24278,1,24278,192758098,256059356,0.752787
24281,1,24281,192782379,256059356,0.752882
24473,1,24473,192806852,256059356,0.752977
24543,1,24543,192831395,256059356,0.753073
24671,1,24671,192856066,256059356,0.753169
24831,1,24831,192880897,256059356,0.753266
24851,1,24851,192905748,256059356,0.753363
24976,1,24976,192930724,256059356,0.753461
25012,1,25012,192955736,256059356,0.753559
25018,1,25018,192980754,256059356,0.753656
25020,1,25020,193005774,256059356,0.753754
25038,1,25038,193030812,256059356,0.753852
25074,1,25074,193055886,256059356,0.75395
25114,1,25114,193081000,256059356,0.754048
25137,1,25137,193106137,256059356,0.754146
25161,1,25161,193131298,256059356,0.754244
25167,1,25167,193156465,256059356,0.754343
25192,1,25192,193181657,256059356,0.754441
25229,1,25229,193206886,256059356,0.754539
25513,1,25513,193232399,256059356,0.754639
25526,1,25526,193257925,256059356,0.754739
25557,1,25557,193283482,256059356,0.754839
25624,2,51248,193334730,256059356,0.755039
25662,1,25662,193360392,256059356,0.755139
25851,1,25851,193386243,256059356,0.75524
25870,1,25870,193412113,256059356,0.755341
25890,1,25890,193438003,256059356,0.755442
26061,1,26061,193464064,256059356,0.755544
26141,1,26141,193490205,256059356,0.755646
26217,1,26217,193516422,256059356,0.755748
26278,1,26278,193542700,256059356,0.755851
26284,2,52568,193595268,256059356,0.756056
26291,1,26291,193621559,256059356,0.756159
26296,1,26296,193647855,256059356,0.756262
26327,1,26327,193674182,256059356,0.756364
26348,1,26348,193700530,256059356,0.756467
26419,1,26419,193726949,256059356,0.75657
26434,1,26434,193753383,256059356,0.756674
26471,1,26471,193779854,256059356,0.756777
26654,1,26654,193806508,256059356,0.756881
26687,1,26687,193833195,256059356,0.756985
26693,1,26693,193859888,256059356,0.75709
26715,1,26715,193886603,256059356,0.757194
26770,1,26770,193913373,256059356,0.757299
26952,1,26952,193940325,256059356,0.757404
27104,1,27104,193967429,256059356,0.75751
27163,1,27163,193994592,256059356,0.757616
27166,1,27166,194021758,256059356,0.757722
27616,1,27616,194049374,256059356,0.75783
27766,1,27766,194077140,256059356,0.757938
27886,1,27886,194105026,256059356,0.758047
27913,1,27913,194132939,256059356,0.758156
28021,2,56042,194188981,256059356,0.758375
28289,1,28289,194217270,256059356,0.758485
28328,1,28328,194245598,256059356,0.758596
28414,1,28414,194274012,256059356,0.758707
28458,1,28458,194302470,256059356,0.758818
28645,1,28645,194331115,256059356,0.75893
28754,1,28754,194359869,256059356,0.759042
28761,1,28761,194388630,256059356,0.759155
28837,1,28837,194417467,256059356,0.759267
28874,1,28874,194446341,256059356,0.75938
28889,1,28889,194475230,256059356,0.759493
28890,1,28890,194504120,256059356,0.759606
28972,1,28972,194533092,256059356,0.759719
29071,1,29071,194562163,256059356,0.759832
29136,1,29136,194591299,256059356,0.759946
29166,1,29166,194620465,256059356,0.76006
29265,1,29265,194649730,256059356,0.760174
29353,1,29353,194679083,256059356,0.760289
29576,1,29576,194708659,256059356,0.760404
29586,1,29586,194738245,256059356,0.76052
29721,1,29721,194767966,256059356,0.760636
29747,1,29747,194797713,256059356,0.760752
29758,1,29758,194827471,256059356,0.760868
29768,1,29768,194857239,256059356,0.760985
29994,1,29994,194887233,256059356,0.761102
30165,1,30165,194917398,256059356,0.76122
30337,1,30337,194947735,256059356,0.761338
30422,1,30422,194978157,256059356,0.761457
30442,1,30442,195008599,256059356,0.761576
30553,1,30553,195039152,256059356,0.761695
30693,1,30693,195069845,256059356,0.761815
30987,1,30987,195100832,256059356,0.761936
31071,1,31071,195131903,256059356,0.762057
31185,1,31185,195163088,256059356,0.762179
31268,2,62536,195225624,256059356,0.762423
31285,1,31285,195256909,256059356,0.762545
31340,1,31340,195288249,256059356,0.762668
31348,1,31348,195319597,256059356,0.76279
31469,1,31469,195351066,256059356,0.762913
31512,1,31512,195382578,256059356,0.763036
31541,1,31541,195414119,256059356,0.763159
31566,1,31566,195445685,256059356,0.763283
31917,1,31917,195477602,256059356,0.763407
31932,1,31932,195509534,256059356,0.763532
31947,1,31947,195541481,256059356,0.763657
31975,1,31975,195573456,256059356,0.763782
32033,1,32033,195605489,256059356,0.763907
32218,1,32218,195637707,256059356,0.764033
32223,1,32223,195669930,256059356,0.764158
32614,1,32614,195702544,256059356,0.764286
32714,1,32714,195735258,256059356,0.764414
32956,1,32956,195768214,256059356,0.764542
33384,1,33384,195801598,256059356,0.764673
33556,2,67112,195868710,256059356,0.764935
33771,1,33771,195902481,256059356,0.765067
34148,1,34148,195936629,256059356,0.7652
34150,1,34150,195970779,256059356,0.765333
34196,1,34196,196004975,256059356,0.765467
34400,1,34400,196039375,256059356,0.765601
34443,1,34443,196073818,256059356,0.765736
34449,1,34449,196108267,256059356,0.76587
34457,1,34457,196142724,256059356,0.766005
34653,1,34653,196177377,256059356,0.76614
34676,1,34676,196212053,256059356,0.766276
34926,1,34926,196246979,256059356,0.766412
35083,1,35083,196282062,256059356,0.766549
35858,1,35858,196317920,256059356,0.766689
35921,1,35921,196353841,256059356,0.766829
36016,1,36016,196389857,256059356,0.76697
36021,1,36021,196425878,256059356,0.767111
36126,1,36126,196462004,256059356,0.767252
36263,1,36263,196498267,256059356,0.767393
36284,1,36284,196534551,256059356,0.767535
36441,1,36441,196570992,256059356,0.767677
36583,1,36583,196607575,256059356,0.76782
36658,1,36658,196644233,256059356,0.767963
36706,1,36706,196680939,256059356,0.768107
36843,1,36843,196717782,256059356,0.768251
37349,1,37349,196755131,256059356,0.768397
37842,2,75684,196830815,256059356,0.768692
38074,1,38074,196868889,256059356,0.768841
38093,1,38093,196906982,256059356,0.76899
38184,1,38184,196945166,256059356,0.769139
38384,1,38384,196983550,256059356,0.769289
38671,1,38671,197022221,256059356,0.76944
39007,1,39007,197061228,256059356,0.769592
39066,1,39066,197100294,256059356,0.769745
39278,1,39278,197139572,256059356,0.769898
39406,1,39406,197178978,256059356,0.770052
39475,1,39475,197218453,256059356,0.770206
39610,1,39610,197258063,256059356,0.770361
39628,1,39628,197297691,256059356,0.770515
39644,1,39644,197337335,256059356,0.77067
39739,1,39739,197377074,256059356,0.770825
39827,1,39827,197416901,256059356,0.770981
39836,1,39836,197456737,256059356,0.771137
39866,1,39866,197496603,256059356,0.771292
39959,1,39959,197536562,256059356,0.771448
39987,1,39987,197576549,256059356,0.771604
40085,1,40085,197616634,256059356,0.771761
40098,1,40098,197656732,256059356,0.771918
40240,2,80480,197737212,256059356,0.772232
40559,1,40559,197777771,256059356,0.77239
40627,1,40627,197818398,256059356,0.772549
40944,1,40944,197859342,256059356,0.772709
41036,1,41036,197900378,256059356,0.772869
41429,1,41429,197941807,256059356,0.773031
41851,1,41851,197983658,256059356,0.773194
42128,1,42128,198025786,256059356,0.773359
42192,1,42192,198067978,256059356,0.773524
42207,1,42207,198110185,256059356,0.773689
42390,1,42390,198152575,256059356,0.773854
42408,1,42408,198194983,256059356,0.77402
42546,1,42546,198237529,256059356,0.774186
43026,1,43026,198280555,256059356,0.774354
43358,1,43358,198323913,256059356,0.774523
43539,1,43539,198367452,256059356,0.774693
44243,1,44243,198411695,256059356,0.774866
44728,1,44728,198456423,256059356,0.775041
44929,1,44929,198501352,256059356,0.775216
44953,1,44953,198546305,256059356,0.775392
45347,1,45347,198591652,256059356,0.775569
45567,1,45567,198637219,256059356,0.775747
45711,1,45711,198682930,256059356,0.775925
45967,1,45967,198728897,256059356,0.776105
45995,1,45995,198774892,256059356,0.776284
46060,1,46060,198820952,256059356,0.776464
46228,1,46228,198867180,256059356,0.776645
46277,1,46277,198913457,256059356,0.776826
46584,1,46584,198960041,256059356,0.777008
46592,1,46592,199006633,256059356,0.777189
46658,1,46658,199053291,256059356,0.777372
46998,1,46998,199100289,256059356,0.777555
47323,1,47323,199147612,256059356,0.77774
47648,1,47648,199195260,256059356,0.777926
47683,1,47683,199242943,256059356,0.778112
47798,1,47798,199290741,256059356,0.778299
47861,1,47861,199338602,256059356,0.778486
47905,1,47905,199386507,256059356,0.778673
48280,1,48280,199434787,256059356,0.778862
48381,1,48381,199483168,256059356,0.77905
48485,1,48485,199531653,256059356,0.77924
48532,1,48532,199580185,256059356,0.779429
48660,1,48660,199628845,256059356,0.779619
48670,1,48670,199677515,256059356,0.779809
48684,1,48684,199726199,256059356,0.78
48914,1,48914,199775113,256059356,0.780191
49035,1,49035,199824148,256059356,0.780382
49049,1,49049,199873197,256059356,0.780574
49083,1,49083,199922280,256059356,0.780765
49163,1,49163,199971443,256059356,0.780957
49240,1,49240,200020683,256059356,0.78115
49313,1,49313,200069996,256059356,0.781342
49391,2,98782,200168778,256059356,0.781728
49828,2,99656,200268434,256059356,0.782117
49877,1,49877,200318311,256059356,0.782312
50095,1,50095,200368406,256059356,0.782508
50280,1,50280,200418686,256059356,0.782704
51021,1,51021,200469707,256059356,0.782903
51617,1,51617,200521324,256059356,0.783105
51812,1,51812,200573136,256059356,0.783307
52021,1,52021,200625157,256059356,0.78351
52368,1,52368,200677525,256059356,0.783715
52602,1,52602,200730127,256059356,0.78392
52711,1,52711,200782838,256059356,0.784126
52963,1,52963,200835801,256059356,0.784333
52998,1,52998,200888799,256059356,0.78454
53110,1,53110,200941909,256059356,0.784747
53149,1,53149,200995058,256059356,0.784955
53202,1,53202,201048260,256059356,0.785163
53290,1,53290,201101550,256059356,0.785371
53367,1,53367,201154917,256059356,0.785579
53679,1,53679,201208596,256059356,0.785789
53829,1,53829,201262425,256059356,0.785999
53991,2,107982,201370407,256059356,0.786421
54033,1,54033,201424440,256059356,0.786632
54320,1,54320,201478760,256059356,0.786844
54326,1,54326,201533086,256059356,0.787056
54838,1,54838,201587924,256059356,0.78727
55324,1,55324,201643248,256059356,0.787486
55858,1,55858,201699106,256059356,0.787704
56103,1,56103,201755209,256059356,0.787924
56327,1,56327,201811536,256059356,0.788144
56703,1,56703,201868239,256059356,0.788365
56716,1,56716,201924955,256059356,0.788587
56886,1,56886,201981841,256059356,0.788809
57097,1,57097,202038938,256059356,0.789032
57285,1,57285,202096223,256059356,0.789255
57543,1,57543,202153766,256059356,0.78948
57574,1,57574,202211340,256059356,0.789705
57575,1,57575,202268915,256059356,0.78993
57596,1,57596,202326511,256059356,0.790155
58279,1,58279,202384790,256059356,0.790382
58563,1,58563,202443353,256059356,0.790611
60944,1,60944,202504297,256059356,0.790849
61477,1,61477,202565774,256059356,0.791089
61610,1,61610,202627384,256059356,0.79133
62293,1,62293,202689677,256059356,0.791573
62294,1,62294,202751971,256059356,0.791816
62428,1,62428,202814399,256059356,0.79206
62820,1,62820,202877219,256059356,0.792305
62920,1,62920,202940139,256059356,0.792551
63549,1,63549,203003688,256059356,0.792799
63726,1,63726,203067414,256059356,0.793048
63781,1,63781,203131195,256059356,0.793297
64044,1,64044,203195239,256059356,0.793547
64110,1,64110,203259349,256059356,0.793798
64287,1,64287,203323636,256059356,0.794049
64427,1,64427,203388063,256059356,0.7943
64699,1,64699,203452762,256059356,0.794553
65001,1,65001,203517763,256059356,0.794807
65141,1,65141,203582904,256059356,0.795061
65346,1,65346,203648250,256059356,0.795317
65594,1,65594,203713844,256059356,0.795573
66082,1,66082,203779926,256059356,0.795831
66383,1,66383,203846309,256059356,0.79609
66754,1,66754,203913063,256059356,0.796351
66759,1,66759,203979822,256059356,0.796611
67059,1,67059,204046881,256059356,0.796873
67629,1,67629,204114510,256059356,0.797137
67795,1,67795,204182305,256059356,0.797402
68261,1,68261,204250566,256059356,0.797669
69157,1,69157,204319723,256059356,0.797939
69241,1,69241,204388964,256059356,0.798209
69632,1,69632,204458596,256059356,0.798481
70153,1,70153,204528749,256059356,0.798755
70442,1,70442,204599191,256059356,0.79903
70486,1,70486,204669677,256059356,0.799306
70649,1,70649,204740326,256059356,0.799582
70974,1,70974,204811300,256059356,0.799859
71776,1,71776,204883076,256059356,0.800139
72063,1,72063,204955139,256059356,0.80042
72408,1,72408,205027547,256059356,0.800703
72468,1,72468,205100015,256059356,0.800986
72559,1,72559,205172574,256059356,0.80127
73167,1,73167,205245741,256059356,0.801555
73331,1,73331,205319072,256059356,0.801842
73349,1,73349,205392421,256059356,0.802128
73361,1,73361,205465782,256059356,0.802415
73367,1,73367,205539149,256059356,0.802701
73369,1,73369,205612518,256059356,0.802988
73448,2,146896,205759414,256059356,0.803561
73449,2,146898,205906312,256059356,0.804135
75109,1,75109,205981421,256059356,0.804428
75123,1,75123,206056544,256059356,0.804722
75188,1,75188,206131732,256059356,0.805015
75477,1,75477,206207209,256059356,0.80531
75623,1,75623,206282832,256059356,0.805606
75634,1,75634,206358466,256059356,0.805901
76609,1,76609,206435075,256059356,0.8062
76653,1,76653,206511728,256059356,0.806499
77426,1,77426,206589154,256059356,0.806802
78984,1,78984,206668138,256059356,0.80711
79364,1,79364,206747502,256059356,0.80742
79974,1,79974,206827476,256059356,0.807733
80166,1,80166,206907642,256059356,0.808046
80589,1,80589,206988231,256059356,0.80836
80833,1,80833,207069064,256059356,0.808676
80840,1,80840,207149904,256059356,0.808992
81128,1,81128,207231032,256059356,0.809309
81584,1,81584,207312616,256059356,0.809627
81929,1,81929,207394545,256059356,0.809947
82172,1,82172,207476717,256059356,0.810268
82299,1,82299,207559016,256059356,0.810589
82394,1,82394,207641410,256059356,0.810911
82429,1,82429,207723839,256059356,0.811233
82630,1,82630,207806469,256059356,0.811556
82698,1,82698,207889167,256059356,0.811879
83780,1,83780,207972947,256059356,0.812206
84145,1,84145,208057092,256059356,0.812535
84173,1,84173,208141265,256059356,0.812863
84864,1,84864,208226129,256059356,0.813195
85008,1,85008,208311137,256059356,0.813527
85283,1,85283,208396420,256059356,0.81386
85323,1,85323,208481743,256059356,0.814193
85549,1,85549,208567292,256059356,0.814527
85979,1,85979,208653271,256059356,0.814863
86793,1,86793,208740064,256059356,0.815202
86798,1,86798,208826862,256059356,0.815541
87067,1,87067,208913929,256059356,0.815881
87566,1,87566,209001495,256059356,0.816223
88107,1,88107,209089602,256059356,0.816567
88198,3,264594,209354196,256059356,0.8176
88576,1,88576,209442772,256059356,0.817946
88785,1,88785,209531557,256059356,0.818293
89180,1,89180,209620737,256059356,0.818641
89228,1,89228,209709965,256059356,0.81899
89230,1,89230,209799195,256059356,0.819338
89247,1,89247,209888442,256059356,0.819687
89343,1,89343,209977785,256059356,0.820036
89938,1,89938,210067723,256059356,0.820387
89966,1,89966,210157689,256059356,0.820738
90149,1,90149,210247838,256059356,0.82109
90359,1,90359,210338197,256059356,0.821443
90395,1,90395,210428592,256059356,0.821796
90449,2,180898,210609490,256059356,0.822503
90453,1,90453,210699943,256059356,0.822856
90470,1,90470,210790413,256059356,0.823209
90493,1,90493,210880906,256059356,0.823563
90629,1,90629,210971535,256059356,0.823917
90642,1,90642,211062177,256059356,0.824271
90644,1,90644,211152821,256059356,0.824625
90649,1,90649,211243470,256059356,0.824979
90650,1,90650,211334120,256059356,0.825333
90655,1,90655,211424775,256059356,0.825687
90656,1,90656,211515431,256059356,0.826041
90770,1,90770,211606201,256059356,0.826395
90871,1,90871,211697072,256059356,0.82675
91070,1,91070,211788142,256059356,0.827106
91277,1,91277,211879419,256059356,0.827462
91457,1,91457,211970876,256059356,0.827819
91580,1,91580,212062456,256059356,0.828177
91586,2,183172,212245628,256059356,0.828892
91789,1,91789,212337417,256059356,0.829251
91838,1,91838,212429255,256059356,0.829609
91840,1,91840,212521095,256059356,0.829968
91936,1,91936,212613031,256059356,0.830327
92549,1,92549,212705580,256059356,0.830689
92732,1,92732,212798312,256059356,0.831051
92738,1,92738,212891050,256059356,0.831413
92835,1,92835,212983885,256059356,0.831775
92920,1,92920,213076805,256059356,0.832138
93042,1,93042,213169847,256059356,0.832502
93322,1,93322,213263169,256059356,0.832866
93343,1,93343,213356512,256059356,0.833231
93520,1,93520,213450032,256059356,0.833596
93647,1,93647,213543679,256059356,0.833962
93709,1,93709,213637388,256059356,0.834328
93721,1,93721,213731109,256059356,0.834694
93743,1,93743,213824852,256059356,0.83506
93917,1,93917,213918769,256059356,0.835426
93954,1,93954,214012723,256059356,0.835793
94648,3,283944,214296667,256059356,0.836902
94652,1,94652,214391319,256059356,0.837272
94830,1,94830,214486149,256059356,0.837642
94956,1,94956,214581105,256059356,0.838013
95414,1,95414,214676519,256059356,0.838386
95923,1,95923,214772442,256059356,0.83876
95982,1,95982,214868424,256059356,0.839135
96420,1,96420,214964844,256059356,0.839512
97278,1,97278,215062122,256059356,0.839892
97851,1,97851,215159973,256059356,0.840274
97857,1,97857,215257830,256059356,0.840656
97871,1,97871,215355701,256059356,0.841038
98027,1,98027,215453728,256059356,0.841421
98374,1,98374,215552102,256059356,0.841805
102201,1,102201,215654303,256059356,0.842204
102673,1,102673,215756976,256059356,0.842605
103048,1,103048,215860024,256059356,0.843008
104874,1,104874,215964898,256059356,0.843417
105013,1,105013,216069911,256059356,0.843827
105357,1,105357,216175268,256059356,0.844239
105930,1,105930,216281198,256059356,0.844653
107152,1,107152,216388350,256059356,0.845071
107156,1,107156,216495506,256059356,0.84549
107169,2,214338,216709844,256059356,0.846327
108137,1,108137,216817981,256059356,0.846749
108575,1,108575,216926556,256059356,0.847173
108744,1,108744,217035300,256059356,0.847598
109513,1,109513,217144813,256059356,0.848025
109517,1,109517,217254330,256059356,0.848453
109610,1,109610,217363940,256059356,0.848881
109695,2,219390,217583330,256059356,0.849738
111182,1,111182,217694512,256059356,0.850172
112675,1,112675,217807187,256059356,0.850612
113423,1,113423,217920610,256059356,0.851055
114844,1,114844,218035454,256059356,0.851504
115617,1,115617,218151071,256059356,0.851955
115624,1,115624,218266695,256059356,0.852407
117842,1,117842,218384537,256059356,0.852867
118760,1,118760,218503297,256059356,0.853331
119732,1,119732,218623029,256059356,0.853798
121507,1,121507,218744536,256059356,0.854273
126912,5,634560,219379096,256059356,0.856751
126913,1,126913,219506009,256059356,0.857247
126914,1,126914,219632923,256059356,0.857742
127005,1,127005,219759928,256059356,0.858238
127545,2,255090,220015018,256059356,0.859234
130457,5,652285,220667303,256059356,0.861782
130460,1,130460,220797763,256059356,0.862291
130461,1,130461,220928224,256059356,0.862801
130666,1,130666,221058890,256059356,0.863311
131992,1,131992,221190882,256059356,0.863827
132036,1,132036,221322918,256059356,0.864342
132194,1,132194,221455112,256059356,0.864859
134602,1,134602,221589714,256059356,0.865384
137333,1,137333,221727047,256059356,0.865921
141214,1,141214,221868261,256059356,0.866472
141221,1,141221,222009482,256059356,0.867024
141397,1,141397,222150879,256059356,0.867576
142975,1,142975,222293854,256059356,0.868134
158977,1,158977,222452831,256059356,0.868755
159841,1,159841,222612672,256059356,0.869379
162271,1,162271,222774943,256059356,0.870013
164965,1,164965,222939908,256059356,0.870657
168584,2,337168,223277076,256059356,0.871974
173261,1,173261,223450337,256059356,0.872651
180812,1,180812,223631149,256059356,0.873357
190102,1,190102,223821251,256059356,0.874099
190424,1,190424,224011675,256059356,0.874843
211899,1,211899,224223574,256059356,0.87567
213508,1,213508,224437082,256059356,0.876504
233090,1,233090,224670172,256059356,0.877414
239845,1,239845,224910017,256059356,0.878351
247140,1,247140,225157157,256059356,0.879316
255447,1,255447,225412604,256059356,0.880314
260914,1,260914,225673518,256059356,0.881333
260917,1,260917,225934435,256059356,0.882352
322455,1,322455,226256890,256059356,0.883611
347647,1,347647,226604537,256059356,0.884969
369754,1,369754,226974291,256059356,0.886413
406422,1,406422,227380713,256059356,0.888
495536,1,495536,227876249,256059356,0.889935
582515,1,582515,228458764,256059356,0.89221
3500121,1,3500121,231958885,256059356,0.905879
3599308,1,3599308,235558193,256059356,0.919936
3687352,1,3687352,239245545,256059356,0.934336
3812296,1,3812296,243057841,256059356,0.949225
3867887,1,3867887,246925728,256059356,0.96433
4414717,1,4414717,251340445,256059356,0.981571
4718911,1,4718911,256059356,256059356,1
