1,123706015,123706015,123706015,256059356,0.483115
2,10933282,21866564,145572579,256059356,0.568511
3,2225770,6677310,152249889,256059356,0.594588
4,1293669,5174676,157424565,256059356,0.614797
5,753726,3768630,161193195,256059356,0.629515
6,493142,2958852,164152047,256059356,0.64107
7,370240,2591680,166743727,256059356,0.651192
8,282306,2258448,169002175,256059356,0.660012
9,210877,1897893,170900068,256059356,0.667424
10,181464,1814640,172714708,256059356,0.67451
11,146817,1614987,174329695,256059356,0.680818
12,144600,1735200,176064895,256059356,0.687594
13,90738,1179594,177244489,256059356,0.692201
14,86018,1204252,178448741,256059356,0.696904
15,71280,1069200,179517941,256059356,0.701079
16,68238,1091808,180609749,256059356,0.705343
17,56865,966705,181576454,256059356,0.709119
18,56148,1010664,182587118,256059356,0.713066
19,62395,1185505,183772623,256059356,0.717695
20,57650,1153000,184925623,256059356,0.722198
21,45807,961947,185887570,256059356,0.725955
22,37867,833074,186720644,256059356,0.729208
23,30954,711942,187432586,256059356,0.731989
24,29709,713016,188145602,256059356,0.734773
25,26746,668650,188814252,256059356,0.737385
26,25653,666978,189481230,256059356,0.739989
27,24863,671301,190152531,256059356,0.742611
28,23540,659120,190811651,256059356,0.745185
29,22174,643046,191454697,256059356,0.747697
30,20245,607350,192062047,256059356,0.750068
31,19287,597897,192659944,256059356,0.752403
32,19119,611808,193271752,256059356,0.754793
33,17299,570867,193842619,256059356,0.757022
34,18237,620058,194462677,256059356,0.759444
35,18237,638295,195100972,256059356,0.761937
36,18472,664992,195765964,256059356,0.764534
37,20051,741887,196507851,256059356,0.767431
38,15639,594282,197102133,256059356,0.769752
39,14920,581880,197684013,256059356,0.772024
40,15249,609960,198293973,256059356,0.774406
41,14864,609424,198903397,256059356,0.776786
42,14667,616014,199519411,256059356,0.779192
43,14046,603978,200123389,256059356,0.781551
44,14499,637956,200761345,256059356,0.784042
45,13800,621000,201382345,256059356,0.786467
46,13277,610742,201993087,256059356,0.788853
47,11677,548819,202541906,256059356,0.790996
48,10798,518304,203060210,256059356,0.79302
49,9368,459032,203519242,256059356,0.794813
50,8703,435150,203954392,256059356,0.796512
51,8675,442425,204396817,256059356,0.79824
52,9070,471640,204868457,256059356,0.800082
53,9204,487812,205356269,256059356,0.801987
54,9648,520992,205877261,256059356,0.804022
55,6761,371855,206249116,256059356,0.805474
56,6517,364952,206614068,256059356,0.806899
57,7213,411141,207025209,256059356,0.808505
58,6550,379900,207405109,256059356,0.809988
59,4722,278598,207683707,256059356,0.811076
60,4637,278220,207961927,256059356,0.812163
61,4408,268888,208230815,256059356,0.813213
62,15372,953064,209183879,256059356,0.816935
63,3958,249354,209433233,256059356,0.817909
64,7687,491968,209925201,256059356,0.81983
65,19025,1236625,211161826,256059356,0.82466
66,5834,385044,211546870,256059356,0.826163
67,3169,212323,211759193,256059356,0.826993
68,2902,197336,211956529,256059356,0.827763
69,2901,200169,212156698,256059356,0.828545
70,4280,299600,212456298,256059356,0.829715
71,4641,329511,212785809,256059356,0.831002
72,6042,435024,213220833,256059356,0.832701
73,8846,645758,213866591,256059356,0.835223
74,6644,491656,214358247,256059356,0.837143
75,10062,754650,215112897,256059356,0.84009
76,5996,455696,215568593,256059356,0.84187
77,4851,373527,215942120,256059356,0.843328
78,9779,762762,216704882,256059356,0.846307
79,15341,1211939,217916821,256059356,0.85104
80,25145,2011600,219928421,256059356,0.858896
81,11320,916920,220845341,256059356,0.862477
82,9580,785560,221630901,256059356,0.865545
83,7516,623828,222254729,256059356,0.867981
84,6874,577416,222832145,256059356,0.870236
85,5578,474130,223306275,256059356,0.872088
86,11706,1006716,224312991,256059356,0.87602
87,8450,735150,225048141,256059356,0.878891
88,6868,604384,225652525,256059356,0.881251
89,5816,517624,226170149,256059356,0.883272
90,4898,440820,226610969,256059356,0.884994
91,6392,581672,227192641,256059356,0.887266
92,4922,452824,227645465,256059356,0.889034
93,5648,525264,228170729,256059356,0.891085
94,6789,638166,228808895,256059356,0.893578
95,9814,932330,229741225,256059356,0.897219
96,7971,765216,230506441,256059356,0.900207
97,5919,574143,231080584,256059356,0.902449
98,5995,587510,231668094,256059356,0.904744
99,6218,615582,232283676,256059356,0.907148
100,6207,620700,232904376,256059356,0.909572
101,4688,473488,233377864,256059356,0.911421
102,4216,430032,233807896,256059356,0.9131
103,3899,401597,234209493,256059356,0.914669
104,2674,278096,234487589,256059356,0.915755
105,2613,274365,234761954,256059356,0.916826
106,2888,306128,235068082,256059356,0.918022
107,3759,402213,235470295,256059356,0.919593
108,1956,211248,235681543,256059356,0.920418
109,1924,209716,235891259,256059356,0.921237
110,1526,167860,236059119,256059356,0.921892
111,1112,123432,236182551,256059356,0.922374
112,1411,158032,236340583,256059356,0.922991
113,1046,118198,236458781,256059356,0.923453
114,758,86412,236545193,256059356,0.92379
115,673,77395,236622588,256059356,0.924093
116,598,69368,236691956,256059356,0.924364
117,516,60372,236752328,256059356,0.924599
118,502,59236,236811564,256059356,0.924831
119,412,49028,236860592,256059356,0.925022
120,556,66720,236927312,256059356,0.925283
121,399,48279,236975591,256059356,0.925471
122,412,50264,237025855,256059356,0.925668
123,342,42066,237067921,256059356,0.925832
124,358,44392,237112313,256059356,0.926005
125,358,44750,237157063,256059356,0.92618
126,330,41580,237198643,256059356,0.926342
127,314,39878,237238521,256059356,0.926498
128,633,81024,237319545,256059356,0.926815
129,305,39345,237358890,256059356,0.926968
130,555,72150,237431040,256059356,0.92725
131,352,46112,237477152,256059356,0.92743
132,956,126192,237603344,256059356,0.927923
133,7982,1061606,238664950,256059356,0.932069
134,510,68340,238733290,256059356,0.932336
135,356,48060,238781350,256059356,0.932523
136,247,33592,238814942,256059356,0.932655
137,233,31921,238846863,256059356,0.932779
138,261,36018,238882881,256059356,0.93292
139,379,52681,238935562,256059356,0.933126
140,736,103040,239038602,256059356,0.933528
141,274,38634,239077236,256059356,0.933679
142,594,84348,239161584,256059356,0.934008
143,344,49192,239210776,256059356,0.9342
144,416,59904,239270680,256059356,0.934434
145,304,44080,239314760,256059356,0.934607
146,993,144978,239459738,256059356,0.935173
147,270,39690,239499428,256059356,0.935328
148,319,47212,239546640,256059356,0.935512
149,503,74947,239621587,256059356,0.935805
150,384,57600,239679187,256059356,0.93603
151,334,50434,239729621,256059356,0.936227
152,366,55632,239785253,256059356,0.936444
153,290,44370,239829623,256059356,0.936617
154,324,49896,239879519,256059356,0.936812
155,301,46655,239926174,256059356,0.936994
156,271,42276,239968450,256059356,0.937159
157,263,41291,240009741,256059356,0.937321
158,272,42976,240052717,256059356,0.937489
159,247,39273,240091990,256059356,0.937642
160,206,32960,240124950,256059356,0.937771
161,259,41699,240166649,256059356,0.937934
162,234,37908,240204557,256059356,0.938082
163,214,34882,240239439,256059356,0.938218
164,166,27224,240266663,256059356,0.938324
165,215,35475,240302138,256059356,0.938463
166,186,30876,240333014,256059356,0.938583
167,173,28891,240361905,256059356,0.938696
168,159,26712,240388617,256059356,0.9388
169,151,25519,240414136,256059356,0.9389
170,123,20910,240435046,256059356,0.938982
171,96,16416,240451462,256059356,0.939046
172,134,23048,240474510,256059356,0.939136
173,110,19030,240493540,256059356,0.93921
174,118,20532,240514072,256059356,0.93929
175,120,21000,240535072,256059356,0.939372
176,102,17952,240553024,256059356,0.939442
177,166,29382,240582406,256059356,0.939557
178,3291,585798,241168204,256059356,0.941845
179,394,70526,241238730,256059356,0.94212
180,432,77760,241316490,256059356,0.942424
181,287,51947,241368437,256059356,0.942627
182,213,38766,241407203,256059356,0.942778
183,159,29097,241436300,256059356,0.942892
184,156,28704,241465004,256059356,0.943004
185,158,29230,241494234,256059356,0.943118
186,213,39618,241533852,256059356,0.943273
187,252,47124,241580976,256059356,0.943457
188,267,50196,241631172,256059356,0.943653
189,179,33831,241665003,256059356,0.943785
190,232,44080,241709083,256059356,0.943957
191,120,22920,241732003,256059356,0.944047
192,132,25344,241757347,256059356,0.944146
193,120,23160,241780507,256059356,0.944236
194,106,20564,241801071,256059356,0.944316
195,117,22815,241823886,256059356,0.944406
196,156,30576,241854462,256059356,0.944525
197,141,27777,241882239,256059356,0.944633
198,105,20790,241903029,256059356,0.944715
199,118,23482,241926511,256059356,0.944806
200,130,26000,241952511,256059356,0.944908
201,145,29145,241981656,256059356,0.945022
202,122,24644,242006300,256059356,0.945118
203,97,19691,242025991,256059356,0.945195
204,95,19380,242045371,256059356,0.945271
205,71,14555,242059926,256059356,0.945327
206,84,17304,242077230,256059356,0.945395
207,82,16974,242094204,256059356,0.945461
208,66,13728,242107932,256059356,0.945515
209,60,12540,242120472,256059356,0.945564
210,39,8190,242128662,256059356,0.945596
211,70,14770,242143432,256059356,0.945654
212,53,11236,242154668,256059356,0.945697
213,71,15123,242169791,256059356,0.945756
214,669,143166,242312957,256059356,0.946316
215,369,79335,242392292,256059356,0.946625
216,318,68688,242460980,256059356,0.946894
217,299,64883,242525863,256059356,0.947147
218,269,58642,242584505,256059356,0.947376
219,212,46428,242630933,256059356,0.947557
220,273,60060,242690993,256059356,0.947792
221,287,63427,242754420,256059356,0.94804
222,247,54834,242809254,256059356,0.948254
223,233,51959,242861213,256059356,0.948457
224,218,48832,242910045,256059356,0.948647
225,189,42525,242952570,256059356,0.948813
226,165,37290,242989860,256059356,0.948959
227,118,26786,243016646,256059356,0.949064
228,124,28272,243044918,256059356,0.949174
229,103,23587,243068505,256059356,0.949266
230,97,22310,243090815,256059356,0.949353
231,97,22407,243113222,256059356,0.949441
232,144,33408,243146630,256059356,0.949571
233,214,49862,243196492,256059356,0.949766
234,86,20124,243216616,256059356,0.949845
235,75,17625,243234241,256059356,0.949914
236,8408,1984288,245218529,256059356,0.957663
237,4980,1180260,246398789,256059356,0.962272
238,3484,829192,247227981,256059356,0.96551
239,2201,526039,247754020,256059356,0.967565
240,1406,337440,248091460,256059356,0.968883
241,1286,309926,248401386,256059356,0.970093
242,645,156090,248557476,256059356,0.970703
243,523,127089,248684565,256059356,0.971199
244,936,228384,248912949,256059356,0.972091
245,643,157535,249070484,256059356,0.972706
246,402,98892,249169376,256059356,0.973092
247,337,83239,249252615,256059356,0.973417
248,269,66712,249319327,256059356,0.973678
249,210,52290,249371617,256059356,0.973882
250,157,39250,249410867,256059356,0.974035
251,129,32379,249443246,256059356,0.974162
252,88,22176,249465422,256059356,0.974248
253,91,23023,249488445,256059356,0.974338
254,90,22860,249511305,256059356,0.974428
255,42,10710,249522015,256059356,0.974469
256,53,13568,249535583,256059356,0.974522
257,68,17476,249553059,256059356,0.974591
258,53,13674,249566733,256059356,0.974644
259,41,10619,249577352,256059356,0.974686
260,38,9880,249587232,256059356,0.974724
261,42,10962,249598194,256059356,0.974767
262,36,9432,249607626,256059356,0.974804
263,29,7627,249615253,256059356,0.974834
264,45,11880,249627133,256059356,0.97488
265,34,9010,249636143,256059356,0.974915
266,39,10374,249646517,256059356,0.974956
267,31,8277,249654794,256059356,0.974988
268,63,16884,249671678,256059356,0.975054
269,29,7801,249679479,256059356,0.975084
270,28,7560,249687039,256059356,0.975114
271,31,8401,249695440,256059356,0.975147
272,22,5984,249701424,256059356,0.97517
273,33,9009,249710433,256059356,0.975205
274,44,12056,249722489,256059356,0.975252
275,19,5225,249727714,256059356,0.975273
276,40,11040,249738754,256059356,0.975316
277,24,6648,249745402,256059356,0.975342
278,23,6394,249751796,256059356,0.975367
279,27,7533,249759329,256059356,0.975396
280,70,19600,249778929,256059356,0.975473
281,42,11802,249790731,256059356,0.975519
282,73,20586,249811317,256059356,0.975599
283,15,4245,249815562,256059356,0.975616
284,24,6816,249822378,256059356,0.975642
285,13,3705,249826083,256059356,0.975657
286,20,5720,249831803,256059356,0.975679
287,14,4018,249835821,256059356,0.975695
288,20,5760,249841581,256059356,0.975717
289,16,4624,249846205,256059356,0.975736
290,9,2610,249848815,256059356,0.975746
291,27,7857,249856672,256059356,0.975776
292,24,7008,249863680,256059356,0.975804
293,19,5567,249869247,256059356,0.975825
294,16,4704,249873951,256059356,0.975844
295,6,1770,249875721,256059356,0.975851
296,18,5328,249881049,256059356,0.975872
297,16,4752,249885801,256059356,0.97589
298,16,4768,249890569,256059356,0.975909
299,13,3887,249894456,256059356,0.975924
300,10,3000,249897456,256059356,0.975936
301,8,2408,249899864,256059356,0.975945
302,13,3926,249903790,256059356,0.97596
303,10,3030,249906820,256059356,0.975972
304,17,5168,249911988,256059356,0.975992
305,15,4575,249916563,256059356,0.97601
306,14,4284,249920847,256059356,0.976027
307,24,7368,249928215,256059356,0.976056
308,14,4312,249932527,256059356,0.976073
309,14,4326,249936853,256059356,0.97609
310,9,2790,249939643,256059356,0.9761
311,15,4665,249944308,256059356,0.976119
312,16,4992,249949300,256059356,0.976138
313,17,5321,249954621,256059356,0.976159
314,15,4710,249959331,256059356,0.976177
315,10,3150,249962481,256059356,0.97619
316,5,1580,249964061,256059356,0.976196
317,8,2536,249966597,256059356,0.976206
318,10,3180,249969777,256059356,0.976218
319,20,6380,249976157,256059356,0.976243
320,13,4160,249980317,256059356,0.976259
321,8,2568,249982885,256059356,0.976269
322,14,4508,249987393,256059356,0.976287
323,12,3876,249991269,256059356,0.976302
324,5,1620,249992889,256059356,0.976308
325,13,4225,249997114,256059356,0.976325
326,10,3260,250000374,256059356,0.976338
327,12,3924,250004298,256059356,0.976353
328,6,1968,250006266,256059356,0.976361
329,6,1974,250008240,256059356,0.976368
330,10,3300,250011540,256059356,0.976381
331,12,3972,250015512,256059356,0.976397
332,14,4648,250020160,256059356,0.976415
333,7,2331,250022491,256059356,0.976424
334,7,2338,250024829,256059356,0.976433
335,13,4355,250029184,256059356,0.97645
336,11,3696,250032880,256059356,0.976465
337,6,2022,250034902,256059356,0.976472
338,6,2028,250036930,256059356,0.97648
339,10,3390,250040320,256059356,0.976494
340,16,5440,250045760,256059356,0.976515
341,11,3751,250049511,256059356,0.976529
342,6,2052,250051563,256059356,0.976537
343,6,2058,250053621,256059356,0.976546
344,6,2064,250055685,256059356,0.976554
345,8,2760,250058445,256059356,0.976564
346,6,2076,250060521,256059356,0.976572
347,5,1735,250062256,256059356,0.976579
348,7,2436,250064692,256059356,0.976589
349,10,3490,250068182,256059356,0.976602
350,16,5600,250073782,256059356,0.976624
351,8,2808,250076590,256059356,0.976635
352,8,2816,250079406,256059356,0.976646
353,6,2118,250081524,256059356,0.976655
354,7,2478,250084002,256059356,0.976664
355,1,355,250084357,256059356,0.976666
356,5,1780,250086137,256059356,0.976673
357,9,3213,250089350,256059356,0.976685
358,11,3938,250093288,256059356,0.9767
359,12,4308,250097596,256059356,0.976717
360,10,3600,250101196,256059356,0.976731
361,13,4693,250105889,256059356,0.97675
362,9,3258,250109147,256059356,0.976762
363,6,2178,250111325,256059356,0.976771
364,12,4368,250115693,256059356,0.976788
365,12,4380,250120073,256059356,0.976805
366,10,3660,250123733,256059356,0.976819
367,6,2202,250125935,256059356,0.976828
368,9,3312,250129247,256059356,0.976841
369,8,2952,250132199,256059356,0.976852
370,5,1850,250134049,256059356,0.97686
371,4,1484,250135533,256059356,0.976865
372,11,4092,250139625,256059356,0.976881
373,11,4103,250143728,256059356,0.976897
374,12,4488,250148216,256059356,0.976915
375,10,3750,250151966,256059356,0.97693
376,19,7144,250159110,256059356,0.976958
377,90,33930,250193040,256059356,0.97709
378,14,5292,250198332,256059356,0.977111
379,5,1895,250200227,256059356,0.977118
380,6,2280,250202507,256059356,0.977127
381,6,2286,250204793,256059356,0.977136
382,7,2674,250207467,256059356,0.977146
383,6,2298,250209765,256059356,0.977155
384,5,1920,250211685,256059356,0.977163
385,8,3080,250214765,256059356,0.977175
386,15,5790,250220555,256059356,0.977197
387,5,1935,250222490,256059356,0.977205
388,3,1164,250223654,256059356,0.97721
389,7,2723,250226377,256059356,0.97722
390,11,4290,250230667,256059356,0.977237
391,1,391,250231058,256059356,0.977238
392,10,3920,250234978,256059356,0.977254
393,10,3930,250238908,256059356,0.977269
394,5,1970,250240878,256059356,0.977277
395,11,4345,250245223,256059356,0.977294
396,4,1584,250246807,256059356,0.9773
397,8,3176,250249983,256059356,0.977312
398,4,1592,250251575,256059356,0.977319
399,11,4389,250255964,256059356,0.977336
400,8,3200,250259164,256059356,0.977348
401,7,2807,250261971,256059356,0.977359
402,5,2010,250263981,256059356,0.977367
403,10,4030,250268011,256059356,0.977383
404,7,2828,250270839,256059356,0.977394
405,1,405,250271244,256059356,0.977395
406,6,2436,250273680,256059356,0.977405
407,13,5291,250278971,256059356,0.977426
408,9,3672,250282643,256059356,0.97744
409,6,2454,250285097,256059356,0.97745
410,4,1640,250286737,256059356,0.977456
411,9,3699,250290436,256059356,0.97747
412,14,5768,250296204,256059356,0.977493
413,82,33866,250330070,256059356,0.977625
414,64,26496,250356566,256059356,0.977729
415,20,8300,250364866,256059356,0.977761
416,11,4576,250369442,256059356,0.977779
417,16,6672,250376114,256059356,0.977805
418,9,3762,250379876,256059356,0.97782
419,10,4190,250384066,256059356,0.977836
420,10,4200,250388266,256059356,0.977852
421,11,4631,250392897,256059356,0.977871
422,6,2532,250395429,256059356,0.97788
423,4,1692,250397121,256059356,0.977887
424,8,3392,250400513,256059356,0.9779
425,4,1700,250402213,256059356,0.977907
426,6,2556,250404769,256059356,0.977917
427,4,1708,250406477,256059356,0.977924
428,4,1712,250408189,256059356,0.97793
429,7,3003,250411192,256059356,0.977942
430,10,4300,250415492,256059356,0.977959
431,4,1724,250417216,256059356,0.977965
432,8,3456,250420672,256059356,0.977979
433,4,1732,250422404,256059356,0.977986
434,4,1736,250424140,256059356,0.977993
435,5,2175,250426315,256059356,0.978001
436,9,3924,250430239,256059356,0.978016
437,2,874,250431113,256059356,0.97802
438,3,1314,250432427,256059356,0.978025
439,4,1756,250434183,256059356,0.978032
440,4,1760,250435943,256059356,0.978039
441,4,1764,250437707,256059356,0.978046
442,5,2210,250439917,256059356,0.978054
443,5,2215,250442132,256059356,0.978063
444,5,2220,250444352,256059356,0.978071
445,4,1780,250446132,256059356,0.978078
446,6,2676,250448808,256059356,0.978089
447,5,2235,250451043,256059356,0.978098
448,5,2240,250453283,256059356,0.978106
449,5,2245,250455528,256059356,0.978115
450,5,2250,250457778,256059356,0.978124
451,4,1804,250459582,256059356,0.978131
452,3,1356,250460938,256059356,0.978136
453,5,2265,250463203,256059356,0.978145
454,5,2270,250465473,256059356,0.978154
455,5,2275,250467748,256059356,0.978163
456,6,2736,250470484,256059356,0.978174
457,7,3199,250473683,256059356,0.978186
458,4,1832,250475515,256059356,0.978193
459,8,3672,250479187,256059356,0.978208
460,3,1380,250480567,256059356,0.978213
461,4,1844,250482411,256059356,0.97822
462,4,1848,250484259,256059356,0.978227
463,7,3241,250487500,256059356,0.97824
464,1,464,250487964,256059356,0.978242
465,2,930,250488894,256059356,0.978245
466,1,466,250489360,256059356,0.978247
467,5,2335,250491695,256059356,0.978256
468,4,1872,250493567,256059356,0.978264
469,6,2814,250496381,256059356,0.978275
470,2,940,250497321,256059356,0.978278
471,7,3297,250500618,256059356,0.978291
472,5,2360,250502978,256059356,0.9783
473,4,1892,250504870,256059356,0.978308
474,4,1896,250506766,256059356,0.978315
475,1,475,250507241,256059356,0.978317
476,5,2380,250509621,256059356,0.978326
477,2,954,250510575,256059356,0.97833
478,5,2390,250512965,256059356,0.978339
479,2,958,250513923,256059356,0.978343
480,5,2400,250516323,256059356,0.978353
481,4,1924,250518247,256059356,0.97836
482,2,964,250519211,256059356,0.978364
483,4,1932,250521143,256059356,0.978371
484,2,968,250522111,256059356,0.978375
485,6,2910,250525021,256059356,0.978387
486,7,3402,250528423,256059356,0.9784
487,4,1948,250530371,256059356,0.978407
488,5,2440,250532811,256059356,0.978417
489,4,1956,250534767,256059356,0.978425
490,1,490,250535257,256059356,0.978426
491,3,1473,250536730,256059356,0.978432
492,8,3936,250540666,256059356,0.978448
493,3,1479,250542145,256059356,0.978453
494,2,988,250543133,256059356,0.978457
495,5,2475,250545608,256059356,0.978467
496,2,992,250546600,256059356,0.978471
497,2,994,250547594,256059356,0.978475
498,3,1494,250549088,256059356,0.978481
499,5,2495,250551583,256059356,0.97849
500,10,5000,250556583,256059356,0.97851
501,13,6513,250563096,256059356,0.978535
502,9,4518,250567614,256059356,0.978553
503,4,2012,250569626,256059356,0.978561
504,6,3024,250572650,256059356,0.978573
505,6,3030,250575680,256059356,0.978584
506,4,2024,250577704,256059356,0.978592
507,4,2028,250579732,256059356,0.9786
508,3,1524,250581256,256059356,0.978606
509,9,4581,250585837,256059356,0.978624
510,4,2040,250587877,256059356,0.978632
511,4,2044,250589921,256059356,0.97864
512,3,1536,250591457,256059356,0.978646
513,6,3078,250594535,256059356,0.978658
514,5,2570,250597105,256059356,0.978668
515,5,2575,250599680,256059356,0.978678
516,4,2064,250601744,256059356,0.978686
517,4,2068,250603812,256059356,0.978694
518,4,2072,250605884,256059356,0.978702
519,7,3633,250609517,256059356,0.978717
520,5,2600,250612117,256059356,0.978727
521,6,3126,250615243,256059356,0.978739
522,4,2088,250617331,256059356,0.978747
523,8,4184,250621515,256059356,0.978763
524,2,1048,250622563,256059356,0.978767
525,2,1050,250623613,256059356,0.978772
526,5,2630,250626243,256059356,0.978782
527,6,3162,250629405,256059356,0.978794
528,9,4752,250634157,256059356,0.978813
529,3,1587,250635744,256059356,0.978819
530,11,5830,250641574,256059356,0.978842
531,5,2655,250644229,256059356,0.978852
532,4,2128,250646357,256059356,0.97886
533,4,2132,250648489,256059356,0.978869
534,5,2670,250651159,256059356,0.978879
535,6,3210,250654369,256059356,0.978892
536,9,4824,250659193,256059356,0.978911
537,5,2685,250661878,256059356,0.978921
538,3,1614,250663492,256059356,0.978927
539,5,2695,250666187,256059356,0.978938
540,3,1620,250667807,256059356,0.978944
541,4,2164,250669971,256059356,0.978953
542,4,2168,250672139,256059356,0.978961
543,3,1629,250673768,256059356,0.978967
544,5,2720,250676488,256059356,0.978978
545,5,2725,250679213,256059356,0.978989
546,6,3276,250682489,256059356,0.979001
547,5,2735,250685224,256059356,0.979012
548,2,1096,250686320,256059356,0.979016
549,5,2745,250689065,256059356,0.979027
550,3,1650,250690715,256059356,0.979034
551,3,1653,250692368,256059356,0.97904
552,2,1104,250693472,256059356,0.979044
553,6,3318,250696790,256059356,0.979057
554,11,6094,250702884,256059356,0.979081
555,6,3330,250706214,256059356,0.979094
556,6,3336,250709550,256059356,0.979107
557,10,5570,250715120,256059356,0.979129
558,5,2790,250717910,256059356,0.97914
559,3,1677,250719587,256059356,0.979146
560,4,2240,250721827,256059356,0.979155
561,8,4488,250726315,256059356,0.979173
562,4,2248,250728563,256059356,0.979181
563,6,3378,250731941,256059356,0.979195
564,3,1692,250733633,256059356,0.979201
565,8,4520,250738153,256059356,0.979219
566,3,1698,250739851,256059356,0.979226
567,14,7938,250747789,256059356,0.979257
568,9,5112,250752901,256059356,0.979276
569,5,2845,250755746,256059356,0.979288
570,8,4560,250760306,256059356,0.979305
571,8,4568,250764874,256059356,0.979323
572,4,2288,250767162,256059356,0.979332
573,3,1719,250768881,256059356,0.979339
574,7,4018,250772899,256059356,0.979355
575,4,2300,250775199,256059356,0.979364
576,3,1728,250776927,256059356,0.97937
577,8,4616,250781543,256059356,0.979388
578,8,4624,250786167,256059356,0.979406
579,5,2895,250789062,256059356,0.979418
580,4,2320,250791382,256059356,0.979427
581,12,6972,250798354,256059356,0.979454
582,2,1164,250799518,256059356,0.979459
583,8,4664,250804182,256059356,0.979477
584,5,2920,250807102,256059356,0.979488
585,3,1755,250808857,256059356,0.979495
586,6,3516,250812373,256059356,0.979509
587,7,4109,250816482,256059356,0.979525
588,10,5880,250822362,256059356,0.979548
589,9,5301,250827663,256059356,0.979568
590,3,1770,250829433,256059356,0.979575
591,4,2364,250831797,256059356,0.979585
592,1,592,250832389,256059356,0.979587
593,8,4744,250837133,256059356,0.979605
594,6,3564,250840697,256059356,0.979619
595,4,2380,250843077,256059356,0.979629
596,4,2384,250845461,256059356,0.979638
597,4,2388,250847849,256059356,0.979647
598,6,3588,250851437,256059356,0.979661
599,3,1797,250853234,256059356,0.979668
600,3,1800,250855034,256059356,0.979675
601,3,1803,250856837,256059356,0.979682
602,5,3010,250859847,256059356,0.979694
603,5,3015,250862862,256059356,0.979706
604,7,4228,250867090,256059356,0.979722
605,4,2420,250869510,256059356,0.979732
606,4,2424,250871934,256059356,0.979741
607,3,1821,250873755,256059356,0.979748
608,6,3648,250877403,256059356,0.979763
609,4,2436,250879839,256059356,0.979772
610,3,1830,250881669,256059356,0.979779
611,6,3666,250885335,256059356,0.979794
612,4,2448,250887783,256059356,0.979803
613,7,4291,250892074,256059356,0.97982
614,8,4912,250896986,256059356,0.979839
615,3,1845,250898831,256059356,0.979846
616,8,4928,250903759,256059356,0.979866
617,9,5553,250909312,256059356,0.979887
618,2,1236,250910548,256059356,0.979892
619,3,1857,250912405,256059356,0.979899
620,12,7440,250919845,256059356,0.979928
621,6,3726,250923571,256059356,0.979943
622,2,1244,250924815,256059356,0.979948
623,1,623,250925438,256059356,0.97995
624,3,1872,250927310,256059356,0.979958
625,7,4375,250931685,256059356,0.979975
626,5,3130,250934815,256059356,0.979987
627,7,4389,250939204,256059356,0.980004
628,3,1884,250941088,256059356,0.980011
629,4,2516,250943604,256059356,0.980021
630,6,3780,250947384,256059356,0.980036
631,4,2524,250949908,256059356,0.980046
632,4,2528,250952436,256059356,0.980056
633,3,1899,250954335,256059356,0.980063
634,10,6340,250960675,256059356,0.980088
635,4,2540,250963215,256059356,0.980098
636,5,3180,250966395,256059356,0.98011
637,3,1911,250968306,256059356,0.980118
638,6,3828,250972134,256059356,0.980133
639,5,3195,250975329,256059356,0.980145
640,3,1920,250977249,256059356,0.980153
641,2,1282,250978531,256059356,0.980158
642,1,642,250979173,256059356,0.98016
644,3,1932,250981105,256059356,0.980168
645,4,2580,250983685,256059356,0.980178
646,3,1938,250985623,256059356,0.980185
647,3,1941,250987564,256059356,0.980193
648,4,2592,250990156,256059356,0.980203
649,4,2596,250992752,256059356,0.980213
650,1,650,250993402,256059356,0.980216
652,8,5216,250998618,256059356,0.980236
653,2,1306,250999924,256059356,0.980241
654,3,1962,251001886,256059356,0.980249
655,4,2620,251004506,256059356,0.980259
657,3,1971,251006477,256059356,0.980267
658,3,1974,251008451,256059356,0.980274
659,4,2636,251011087,256059356,0.980285
660,4,2640,251013727,256059356,0.980295
661,2,1322,251015049,256059356,0.9803
662,2,1324,251016373,256059356,0.980305
663,1,663,251017036,256059356,0.980308
664,3,1992,251019028,256059356,0.980316
665,2,1330,251020358,256059356,0.980321
666,2,1332,251021690,256059356,0.980326
668,1,668,251022358,256059356,0.980329
669,2,1338,251023696,256059356,0.980334
670,2,1340,251025036,256059356,0.980339
671,2,1342,251026378,256059356,0.980344
672,2,1344,251027722,256059356,0.98035
673,2,1346,251029068,256059356,0.980355
674,1,674,251029742,256059356,0.980358
676,2,1352,251031094,256059356,0.980363
678,1,678,251031772,256059356,0.980366
679,1,679,251032451,256059356,0.980368
680,2,1360,251033811,256059356,0.980374
681,3,2043,251035854,256059356,0.980381
682,3,2046,251037900,256059356,0.980389
683,3,2049,251039949,256059356,0.980397
684,5,3420,251043369,256059356,0.980411
685,3,2055,251045424,256059356,0.980419
686,7,4802,251050226,256059356,0.980438
687,2,1374,251051600,256059356,0.980443
688,2,1376,251052976,256059356,0.980448
689,1,689,251053665,256059356,0.980451
690,2,1380,251055045,256059356,0.980456
691,3,2073,251057118,256059356,0.980465
692,3,2076,251059194,256059356,0.980473
693,1,693,251059887,256059356,0.980475
694,1,694,251060581,256059356,0.980478
697,3,2091,251062672,256059356,0.980486
700,1,700,251063372,256059356,0.980489
701,1,701,251064073,256059356,0.980492
702,1,702,251064775,256059356,0.980494
703,2,1406,251066181,256059356,0.9805
704,2,1408,251067589,256059356,0.980505
705,3,2115,251069704,256059356,0.980514
706,3,2118,251071822,256059356,0.980522
707,3,2121,251073943,256059356,0.98053
708,1,708,251074651,256059356,0.980533
709,4,2836,251077487,256059356,0.980544
710,2,1420,251078907,256059356,0.98055
711,1,711,251079618,256059356,0.980552
712,4,2848,251082466,256059356,0.980564
714,1,714,251083180,256059356,0.980566
715,1,715,251083895,256059356,0.980569
716,2,1432,251085327,256059356,0.980575
717,2,1434,251086761,256059356,0.98058
718,1,718,251087479,256059356,0.980583
719,2,1438,251088917,256059356,0.980589
720,1,720,251089637,256059356,0.980592
722,3,2166,251091803,256059356,0.9806
723,2,1446,251093249,256059356,0.980606
724,2,1448,251094697,256059356,0.980611
727,3,2181,251096878,256059356,0.98062
728,4,2912,251099790,256059356,0.980631
729,3,2187,251101977,256059356,0.98064
730,5,3650,251105627,256059356,0.980654
731,2,1462,251107089,256059356,0.98066
732,1,732,251107821,256059356,0.980663
733,4,2932,251110753,256059356,0.980674
736,3,2208,251112961,256059356,0.980683
737,3,2211,251115172,256059356,0.980691
738,2,1476,251116648,256059356,0.980697
739,1,739,251117387,256059356,0.9807
740,2,1480,251118867,256059356,0.980706
741,1,741,251119608,256059356,0.980709
742,3,2226,251121834,256059356,0.980717
743,1,743,251122577,256059356,0.98072
744,1,744,251123321,256059356,0.980723
745,2,1490,251124811,256059356,0.980729
746,2,1492,251126303,256059356,0.980735
747,1,747,251127050,256059356,0.980738
749,3,2247,251129297,256059356,0.980746
750,4,3000,251132297,256059356,0.980758
751,1,751,251133048,256059356,0.980761
752,1,752,251133800,256059356,0.980764
753,1,753,251134553,256059356,0.980767
754,1,754,251135307,256059356,0.98077
755,2,1510,251136817,256059356,0.980776
756,2,1512,251138329,256059356,0.980782
757,2,1514,251139843,256059356,0.980788
758,1,758,251140601,256059356,0.980791
760,1,760,251141361,256059356,0.980794
761,2,1522,251142883,256059356,0.980799
762,5,3810,251146693,256059356,0.980814
763,3,2289,251148982,256059356,0.980823
764,2,1528,251150510,256059356,0.980829
765,3,2295,251152805,256059356,0.980838
766,3,2298,251155103,256059356,0.980847
767,1,767,251155870,256059356,0.98085
768,2,1536,251157406,256059356,0.980856
769,1,769,251158175,256059356,0.980859
770,7,5390,251163565,256059356,0.98088
771,1,771,251164336,256059356,0.980883
772,2,1544,251165880,256059356,0.980889
773,1,773,251166653,256059356,0.980892
776,1,776,251167429,256059356,0.980895
777,2,1554,251168983,256059356,0.980901
778,1,778,251169761,256059356,0.980904
780,1,780,251170541,256059356,0.980907
782,3,2346,251172887,256059356,0.980917
783,1,783,251173670,256059356,0.98092
784,2,1568,251175238,256059356,0.980926
785,1,785,251176023,256059356,0.980929
786,2,1572,251177595,256059356,0.980935
787,2,1574,251179169,256059356,0.980941
790,1,790,251179959,256059356,0.980944
791,3,2373,251182332,256059356,0.980954
792,2,1584,251183916,256059356,0.98096
793,2,1586,251185502,256059356,0.980966
795,2,1590,251187092,256059356,0.980972
796,1,796,251187888,256059356,0.980975
797,4,3188,251191076,256059356,0.980988
800,3,2400,251193476,256059356,0.980997
801,1,801,251194277,256059356,0.981
802,1,802,251195079,256059356,0.981003
803,2,1606,251196685,256059356,0.98101
805,1,805,251197490,256059356,0.981013
806,2,1612,251199102,256059356,0.981019
807,4,3228,251202330,256059356,0.981032
808,1,808,251203138,256059356,0.981035
811,2,1622,251204760,256059356,0.981041
812,1,812,251205572,256059356,0.981044
814,2,1628,251207200,256059356,0.981051
816,2,1632,251208832,256059356,0.981057
817,2,1634,251210466,256059356,0.981063
818,2,1636,251212102,256059356,0.98107
819,1,819,251212921,256059356,0.981073
820,1,820,251213741,256059356,0.981076
821,1,821,251214562,256059356,0.981079
822,3,2466,251217028,256059356,0.981089
824,2,1648,251218676,256059356,0.981095
826,7,5782,251224458,256059356,0.981118
827,56,46312,251270770,256059356,0.981299
828,8,6624,251277394,256059356,0.981325
829,3,2487,251279881,256059356,0.981335
830,1,830,251280711,256059356,0.981338
831,2,1662,251282373,256059356,0.981344
832,2,1664,251284037,256059356,0.981351
833,4,3332,251287369,256059356,0.981364
834,2,1668,251289037,256059356,0.98137
836,1,836,251289873,256059356,0.981374
837,1,837,251290710,256059356,0.981377
838,3,2514,251293224,256059356,0.981387
839,2,1678,251294902,256059356,0.981393
841,2,1682,251296584,256059356,0.9814
842,2,1684,251298268,256059356,0.981406
843,2,1686,251299954,256059356,0.981413
844,1,844,251300798,256059356,0.981416
847,1,847,251301645,256059356,0.981419
848,1,848,251302493,256059356,0.981423
849,2,1698,251304191,256059356,0.981429
850,2,1700,251305891,256059356,0.981436
851,2,1702,251307593,256059356,0.981443
852,1,852,251308445,256059356,0.981446
853,3,2559,251311004,256059356,0.981456
854,2,1708,251312712,256059356,0.981463
855,3,2565,251315277,256059356,0.981473
857,1,857,251316134,256059356,0.981476
859,4,3436,251319570,256059356,0.98149
861,3,2583,251322153,256059356,0.9815
862,2,1724,251323877,256059356,0.981506
865,1,865,251324742,256059356,0.98151
866,1,866,251325608,256059356,0.981513
867,3,2601,251328209,256059356,0.981523
869,1,869,251329078,256059356,0.981527
870,1,870,251329948,256059356,0.98153
871,1,871,251330819,256059356,0.981533
872,2,1744,251332563,256059356,0.98154
873,1,873,251333436,256059356,0.981544
876,4,3504,251336940,256059356,0.981557
878,1,878,251337818,256059356,0.981561
879,2,1758,251339576,256059356,0.981568
880,1,880,251340456,256059356,0.981571
881,1,881,251341337,256059356,0.981575
884,3,2652,251343989,256059356,0.981585
885,1,885,251344874,256059356,0.981588
886,1,886,251345760,256059356,0.981592
887,1,887,251346647,256059356,0.981595
889,5,4445,251351092,256059356,0.981613
890,1,890,251351982,256059356,0.981616
893,1,893,251352875,256059356,0.98162
895,1,895,251353770,256059356,0.981623
896,2,1792,251355562,256059356,0.98163
897,2,1794,251357356,256059356,0.981637
899,1,899,251358255,256059356,0.981641
901,2,1802,251360057,256059356,0.981648
902,2,1804,251361861,256059356,0.981655
903,1,903,251362764,256059356,0.981658
904,3,2712,251365476,256059356,0.981669
905,3,2715,251368191,256059356,0.981679
906,2,1812,251370003,256059356,0.981686
908,1,908,251370911,256059356,0.98169
909,1,909,251371820,256059356,0.981694
913,1,913,251372733,256059356,0.981697
915,2,1830,251374563,256059356,0.981704
917,1,917,251375480,256059356,0.981708
918,1,918,251376398,256059356,0.981711
919,1,919,251377317,256059356,0.981715
921,3,2763,251380080,256059356,0.981726
922,2,1844,251381924,256059356,0.981733
926,1,926,251382850,256059356,0.981737
929,2,1858,251384708,256059356,0.981744
930,2,1860,251386568,256059356,0.981751
934,2,1868,251388436,256059356,0.981758
936,1,936,251389372,256059356,0.981762
937,2,1874,251391246,256059356,0.981769
939,1,939,251392185,256059356,0.981773
940,2,1880,251394065,256059356,0.98178
941,1,941,251395006,256059356,0.981784
942,1,942,251395948,256059356,0.981788
943,1,943,251396891,256059356,0.981791
944,1,944,251397835,256059356,0.981795
947,2,1894,251399729,256059356,0.981803
948,3,2844,251402573,256059356,0.981814
949,1,949,251403522,256059356,0.981817
951,1,951,251404473,256059356,0.981821
952,1,952,251405425,256059356,0.981825
955,1,955,251406380,256059356,0.981829
957,1,957,251407337,256059356,0.981832
959,1,959,251408296,256059356,0.981836
960,1,960,251409256,256059356,0.98184
963,1,963,251410219,256059356,0.981844
965,1,965,251411184,256059356,0.981847
967,2,1934,251413118,256059356,0.981855
968,1,968,251414086,256059356,0.981859
969,1,969,251415055,256059356,0.981862
970,2,1940,251416995,256059356,0.98187
971,3,2913,251419908,256059356,0.981881
975,1,975,251420883,256059356,0.981885
976,2,1952,251422835,256059356,0.981893
978,2,1956,251424791,256059356,0.9819
979,1,979,251425770,256059356,0.981904
981,2,1962,251427732,256059356,0.981912
984,1,984,251428716,256059356,0.981916
985,1,985,251429701,256059356,0.98192
987,1,987,251430688,256059356,0.981923
988,1,988,251431676,256059356,0.981927
989,1,989,251432665,256059356,0.981931
990,1,990,251433655,256059356,0.981935
992,2,1984,251435639,256059356,0.981943
994,2,1988,251437627,256059356,0.981951
995,2,1990,251439617,256059356,0.981958
999,2,1998,251441615,256059356,0.981966
1000,1,1000,251442615,256059356,0.98197
1004,4,4016,251446631,256059356,0.981986
1006,1,1006,251447637,256059356,0.98199
1007,1,1007,251448644,256059356,0.981994
1009,3,3027,251451671,256059356,0.982005
1012,1,1012,251452683,256059356,0.982009
1013,2,2026,251454709,256059356,0.982017
1014,1,1014,251455723,256059356,0.982021
1016,2,2032,251457755,256059356,0.982029
1017,1,1017,251458772,256059356,0.982033
1019,1,1019,251459791,256059356,0.982037
1021,1,1021,251460812,256059356,0.982041
1022,1,1022,251461834,256059356,0.982045
1024,1,1024,251462858,256059356,0.982049
1025,1,1025,251463883,256059356,0.982053
1031,1,1031,251464914,256059356,0.982057
1033,1,1033,251465947,256059356,0.982061
1035,2,2070,251468017,256059356,0.982069
1036,1,1036,251469053,256059356,0.982073
1040,1,1040,251470093,256059356,0.982077
1041,1,1041,251471134,256059356,0.982081
1042,1,1042,251472176,256059356,0.982085
1043,1,1043,251473219,256059356,0.98209
1046,1,1046,251474265,256059356,0.982094
1048,1,1048,251475313,256059356,0.982098
1049,1,1049,251476362,256059356,0.982102
1050,2,2100,251478462,256059356,0.98211
1052,1,1052,251479514,256059356,0.982114
1053,2,2106,251481620,256059356,0.982122
1054,2,2108,251483728,256059356,0.982131
1057,2,2114,251485842,256059356,0.982139
1061,1,1061,251486903,256059356,0.982143
1063,2,2126,251489029,256059356,0.982151
1066,2,2132,251491161,256059356,0.98216
1069,1,1069,251492230,256059356,0.982164
1070,1,1070,251493300,256059356,0.982168
1071,1,1071,251494371,256059356,0.982172
1073,1,1073,251495444,256059356,0.982176
1074,1,1074,251496518,256059356,0.982181
1076,1,1076,251497594,256059356,0.982185
1077,1,1077,251498671,256059356,0.982189
1079,1,1079,251499750,256059356,0.982193
1081,1,1081,251500831,256059356,0.982197
1082,1,1082,251501913,256059356,0.982202
1084,1,1084,251502997,256059356,0.982206
1087,1,1087,251504084,256059356,0.98221
1088,1,1088,251505172,256059356,0.982214
1090,1,1090,251506262,256059356,0.982219
1094,1,1094,251507356,256059356,0.982223
1097,1,1097,251508453,256059356,0.982227
1099,2,2198,251510651,256059356,0.982236
1101,1,1101,251511752,256059356,0.98224
1103,1,1103,251512855,256059356,0.982244
1104,1,1104,251513959,256059356,0.982249
1105,3,3315,251517274,256059356,0.982262
1106,1,1106,251518380,256059356,0.982266
1108,1,1108,251519488,256059356,0.98227
1110,1,1110,251520598,256059356,0.982275
1111,2,2222,251522820,256059356,0.982283
1113,1,1113,251523933,256059356,0.982288
1115,1,1115,251525048,256059356,0.982292
1117,1,1117,251526165,256059356,0.982296
1119,3,3357,251529522,256059356,0.982309
1121,1,1121,251530643,256059356,0.982314
1122,1,1122,251531765,256059356,0.982318
1125,1,1125,251532890,256059356,0.982323
1127,1,1127,251534017,256059356,0.982327
1129,1,1129,251535146,256059356,0.982331
1131,1,1131,251536277,256059356,0.982336
1132,2,2264,251538541,256059356,0.982345
1133,1,1133,251539674,256059356,0.982349
1136,1,1136,251540810,256059356,0.982354
1142,1,1142,251541952,256059356,0.982358
1144,1,1144,251543096,256059356,0.982362
1149,2,2298,251545394,256059356,0.982371
1150,2,2300,251547694,256059356,0.98238
1151,2,2302,251549996,256059356,0.982389
1152,1,1152,251551148,256059356,0.982394
1153,1,1153,251552301,256059356,0.982398
1155,1,1155,251553456,256059356,0.982403
1156,1,1156,251554612,256059356,0.982407
1157,2,2314,251556926,256059356,0.982416
1158,1,1158,251558084,256059356,0.982421
1165,1,1165,251559249,256059356,0.982426
1166,2,2332,251561581,256059356,0.982435
1167,3,3501,251565082,256059356,0.982448
1171,2,2342,251567424,256059356,0.982457
1175,1,1175,251568599,256059356,0.982462
1176,1,1176,251569775,256059356,0.982467
1177,1,1177,251570952,256059356,0.982471
1178,1,1178,251572130,256059356,0.982476
1180,1,1180,251573310,256059356,0.98248
1183,1,1183,251574493,256059356,0.982485
1189,2,2378,251576871,256059356,0.982494
1193,1,1193,251578064,256059356,0.982499
1194,1,1194,251579258,256059356,0.982504
1195,2,2390,251581648,256059356,0.982513
1197,2,2394,251584042,256059356,0.982522
1198,1,1198,251585240,256059356,0.982527
1200,2,2400,251587640,256059356,0.982536
1201,3,3603,251591243,256059356,0.98255
1202,1,1202,251592445,256059356,0.982555
1204,1,1204,251593649,256059356,0.98256
1209,1,1209,251594858,256059356,0.982565
1210,2,2420,251597278,256059356,0.982574
1214,2,2428,251599706,256059356,0.982584
1215,1,1215,251600921,256059356,0.982588
1220,1,1220,251602141,256059356,0.982593
1221,1,1221,251603362,256059356,0.982598
1222,1,1222,251604584,256059356,0.982603
1224,2,2448,251607032,256059356,0.982612
1229,1,1229,251608261,256059356,0.982617
1236,1,1236,251609497,256059356,0.982622
1237,1,1237,251610734,256059356,0.982627
1239,1,1239,251611973,256059356,0.982631
1241,1,1241,251613214,256059356,0.982636
1242,1,1242,251614456,256059356,0.982641
1244,1,1244,251615700,256059356,0.982646
1249,1,1249,251616949,256059356,0.982651
1250,1,1250,251618199,256059356,0.982656
1252,1,1252,251619451,256059356,0.982661
1253,1,1253,251620704,256059356,0.982666
1254,2,2508,251623212,256059356,0.982675
1258,1,1258,251624470,256059356,0.98268
1259,1,1259,251625729,256059356,0.982685
1265,1,1265,251626994,256059356,0.98269
1267,1,1267,251628261,256059356,0.982695
1271,1,1271,251629532,256059356,0.9827
1272,1,1272,251630804,256059356,0.982705
1274,1,1274,251632078,256059356,0.98271
1275,1,1275,251633353,256059356,0.982715
1279,1,1279,251634632,256059356,0.98272
1285,1,1285,251635917,256059356,0.982725
1288,1,1288,251637205,256059356,0.98273
1289,1,1289,251638494,256059356,0.982735
1295,1,1295,251639789,256059356,0.98274
1296,1,1296,251641085,256059356,0.982745
1297,1,1297,251642382,256059356,0.98275
1300,1,1300,251643682,256059356,0.982755
1301,1,1301,251644983,256059356,0.98276
1307,2,2614,251647597,256059356,0.982771
1308,1,1308,251648905,256059356,0.982776
1315,1,1315,251650220,256059356,0.982781
1316,1,1316,251651536,256059356,0.982786
1324,4,5296,251656832,256059356,0.982807
1326,1,1326,251658158,256059356,0.982812
1329,1,1329,251659487,256059356,0.982817
1331,1,1331,251660818,256059356,0.982822
1332,1,1332,251662150,256059356,0.982827
1333,1,1333,251663483,256059356,0.982833
1335,1,1335,251664818,256059356,0.982838
1348,1,1348,251666166,256059356,0.982843
1355,1,1355,251667521,256059356,0.982848
1359,1,1359,251668880,256059356,0.982854
1362,1,1362,251670242,256059356,0.982859
1366,1,1366,251671608,256059356,0.982864
1371,1,1371,251672979,256059356,0.98287
1372,1,1372,251674351,256059356,0.982875
1376,2,2752,251677103,256059356,0.982886
1377,2,2754,251679857,256059356,0.982897
1379,1,1379,251681236,256059356,0.982902
1390,1,1390,251682626,256059356,0.982907
1395,1,1395,251684021,256059356,0.982913
1401,2,2802,251686823,256059356,0.982924
1405,1,1405,251688228,256059356,0.982929
1411,1,1411,251689639,256059356,0.982935
1414,1,1414,251691053,256059356,0.98294
1419,1,1419,251692472,256059356,0.982946
1433,1,1433,251693905,256059356,0.982951
1444,1,1444,251695349,256059356,0.982957
1445,1,1445,251696794,256059356,0.982963
1447,1,1447,251698241,256059356,0.982968
1453,1,1453,251699694,256059356,0.982974
1459,1,1459,251701153,256059356,0.98298
1460,1,1460,251702613,256059356,0.982985
1475,1,1475,251704088,256059356,0.982991
1477,1,1477,251705565,256059356,0.982997
1485,2,2970,251708535,256059356,0.983009
1497,2,2994,251711529,256059356,0.98302
1498,1,1498,251713027,256059356,0.983026
1507,1,1507,251714534,256059356,0.983032
1511,1,1511,251716045,256059356,0.983038
1516,1,1516,251717561,256059356,0.983044
1519,1,1519,251719080,256059356,0.98305
1532,1,1532,251720612,256059356,0.983056
1537,1,1537,251722149,256059356,0.983062
1545,1,1545,251723694,256059356,0.983068
1553,1,1553,251725247,256059356,0.983074
1557,1,1557,251726804,256059356,0.98308
1561,1,1561,251728365,256059356,0.983086
1562,1,1562,251729927,256059356,0.983092
1568,1,1568,251731495,256059356,0.983098
1575,1,1575,251733070,256059356,0.983104
1582,1,1582,251734652,256059356,0.983111
1597,1,1597,251736249,256059356,0.983117
1606,1,1606,251737855,256059356,0.983123
1607,1,1607,251739462,256059356,0.983129
1622,1,1622,251741084,256059356,0.983136
1623,1,1623,251742707,256059356,0.983142
1625,1,1625,251744332,256059356,0.983148
1632,1,1632,251745964,256059356,0.983155
1636,1,1636,251747600,256059356,0.983161
1651,1,1651,251749251,256059356,0.983168
1653,1,1653,251750904,256059356,0.983174
1659,1,1659,251752563,256059356,0.98318
1660,1,1660,251754223,256059356,0.983187
1677,1,1677,251755900,256059356,0.983194
1688,1,1688,251757588,256059356,0.9832
1691,1,1691,251759279,256059356,0.983207
1698,1,1698,251760977,256059356,0.983213
1702,1,1702,251762679,256059356,0.98322
1705,1,1705,251764384,256059356,0.983227
1708,1,1708,251766092,256059356,0.983233
1720,1,1720,251767812,256059356,0.98324
1727,1,1727,251769539,256059356,0.983247
1728,1,1728,251771267,256059356,0.983254
1748,1,1748,251773015,256059356,0.98326
1755,1,1755,251774770,256059356,0.983267
1758,1,1758,251776528,256059356,0.983274
1765,1,1765,251778293,256059356,0.983281
1769,1,1769,251780062,256059356,0.983288
1777,1,1777,251781839,256059356,0.983295
1786,1,1786,251783625,256059356,0.983302
1787,1,1787,251785412,256059356,0.983309
1794,1,1794,251787206,256059356,0.983316
1812,2,3624,251790830,256059356,0.98333
1820,1,1820,251792650,256059356,0.983337
1824,1,1824,251794474,256059356,0.983344
1831,1,1831,251796305,256059356,0.983351
1835,1,1835,251798140,256059356,0.983358
1852,1,1852,251799992,256059356,0.983366
1853,1,1853,251801845,256059356,0.983373
1865,1,1865,251803710,256059356,0.98338
1874,1,1874,251805584,256059356,0.983388
1877,1,1877,251807461,256059356,0.983395
1879,1,1879,251809340,256059356,0.983402
1882,1,1882,251811222,256059356,0.98341
1887,1,1887,251813109,256059356,0.983417
1894,1,1894,251815003,256059356,0.983424
1905,1,1905,251816908,256059356,0.983432
1906,1,1906,251818814,256059356,0.983439
1907,1,1907,251820721,256059356,0.983447
1911,1,1911,251822632,256059356,0.983454
1934,1,1934,251824566,256059356,0.983462
1948,1,1948,251826514,256059356,0.983469
1957,2,3914,251830428,256059356,0.983485
1959,1,1959,251832387,256059356,0.983492
1972,1,1972,251834359,256059356,0.9835
1983,1,1983,251836342,256059356,0.983508
1986,1,1986,251838328,256059356,0.983515
1995,1,1995,251840323,256059356,0.983523
1997,1,1997,251842320,256059356,0.983531
2004,1,2004,251844324,256059356,0.983539
2011,1,2011,251846335,256059356,0.983547
2016,1,2016,251848351,256059356,0.983555
2018,1,2018,251850369,256059356,0.983562
2022,1,2022,251852391,256059356,0.98357
2023,1,2023,251854414,256059356,0.983578
2025,1,2025,251856439,256059356,0.983586
2043,1,2043,251858482,256059356,0.983594
2045,1,2045,251860527,256059356,0.983602
2052,1,2052,251862579,256059356,0.98361
2059,1,2059,251864638,256059356,0.983618
2066,1,2066,251866704,256059356,0.983626
2068,1,2068,251868772,256059356,0.983634
2095,1,2095,251870867,256059356,0.983643
2114,1,2114,251872981,256059356,0.983651
2121,1,2121,251875102,256059356,0.983659
2123,1,2123,251877225,256059356,0.983667
2139,1,2139,251879364,256059356,0.983676
2140,1,2140,251881504,256059356,0.983684
2141,1,2141,251883645,256059356,0.983692
2149,1,2149,251885794,256059356,0.983701
2153,1,2153,251887947,256059356,0.983709
2170,1,2170,251890117,256059356,0.983718
2177,1,2177,251892294,256059356,0.983726
2179,1,2179,251894473,256059356,0.983735
2183,1,2183,251896656,256059356,0.983743
2211,1,2211,251898867,256059356,0.983752
2212,1,2212,251901079,256059356,0.98376
2244,1,2244,251903323,256059356,0.983769
2248,1,2248,251905571,256059356,0.983778
2257,1,2257,251907828,256059356,0.983787
2276,1,2276,251910104,256059356,0.983796
2306,1,2306,251912410,256059356,0.983805
2311,1,2311,251914721,256059356,0.983814
2324,1,2324,251917045,256059356,0.983823
2357,1,2357,251919402,256059356,0.983832
2358,1,2358,251921760,256059356,0.983841
2387,1,2387,251924147,256059356,0.983851
2436,1,2436,251926583,256059356,0.98386
2449,1,2449,251929032,256059356,0.98387
2456,1,2456,251931488,256059356,0.983879
2462,1,2462,251933950,256059356,0.983889
2491,1,2491,251936441,256059356,0.983899
2495,1,2495,251938936,256059356,0.983908
2497,1,2497,251941433,256059356,0.983918
2504,1,2504,251943937,256059356,0.983928
2512,1,2512,251946449,256059356,0.983938
2581,1,2581,251949030,256059356,0.983948
2639,1,2639,251951669,256059356,0.983958
2640,1,2640,251954309,256059356,0.983968
2670,1,2670,251956979,256059356,0.983979
2679,1,2679,251959658,256059356,0.983989
2692,1,2692,251962350,256059356,0.984
2697,1,2697,251965047,256059356,0.98401
2714,1,2714,251967761,256059356,0.984021
2724,1,2724,251970485,256059356,0.984032
2725,1,2725,251973210,256059356,0.984042
2746,1,2746,251975956,256059356,0.984053
2747,1,2747,251978703,256059356,0.984064
2764,1,2764,251981467,256059356,0.984074
2810,1,2810,251984277,256059356,0.984085
2839,1,2839,251987116,256059356,0.984096
2867,1,2867,251989983,256059356,0.984108
2884,2,5768,251995751,256059356,0.98413
2894,1,2894,251998645,256059356,0.984142
2901,2,5802,252004447,256059356,0.984164
2904,1,2904,252007351,256059356,0.984176
2953,1,2953,252010304,256059356,0.984187
2964,1,2964,252013268,256059356,0.984199
2967,1,2967,252016235,256059356,0.98421
2986,1,2986,252019221,256059356,0.984222
2993,1,2993,252022214,256059356,0.984234
3000,1,3000,252025214,256059356,0.984245
3007,1,3007,252028221,256059356,0.984257
3009,1,3009,252031230,256059356,0.984269
3051,1,3051,252034281,256059356,0.984281
3088,1,3088,252037369,256059356,0.984293
3095,1,3095,252040464,256059356,0.984305
3097,1,3097,252043561,256059356,0.984317
3103,1,3103,252046664,256059356,0.984329
3106,1,3106,252049770,256059356,0.984341
3108,1,3108,252052878,256059356,0.984353
3122,1,3122,252056000,256059356,0.984366
3126,1,3126,252059126,256059356,0.984378
3141,1,3141,252062267,256059356,0.98439
3147,1,3147,252065414,256059356,0.984402
3151,1,3151,252068565,256059356,0.984415
3166,1,3166,252071731,256059356,0.984427
3188,1,3188,252074919,256059356,0.984439
3244,1,3244,252078163,256059356,0.984452
3315,1,3315,252081478,256059356,0.984465
3318,1,3318,252084796,256059356,0.984478
3327,1,3327,252088123,256059356,0.984491
3336,1,3336,252091459,256059356,0.984504
3342,1,3342,252094801,256059356,0.984517
3362,1,3362,252098163,256059356,0.98453
3373,1,3373,252101536,256059356,0.984543
3381,1,3381,252104917,256059356,0.984557
3432,1,3432,252108349,256059356,0.98457
3443,1,3443,252111792,256059356,0.984583
3547,1,3547,252115339,256059356,0.984597
3557,2,7114,252122453,256059356,0.984625
3598,1,3598,252126051,256059356,0.984639
3599,1,3599,252129650,256059356,0.984653
3673,1,3673,252133323,256059356,0.984667
3685,1,3685,252137008,256059356,0.984682
3700,1,3700,252140708,256059356,0.984696
3707,1,3707,252144415,256059356,0.984711
3733,1,3733,252148148,256059356,0.984725
3763,1,3763,252151911,256059356,0.98474
3783,1,3783,252155694,256059356,0.984755
3811,1,3811,252159505,256059356,0.98477
3825,1,3825,252163330,256059356,0.984785
3837,1,3837,252167167,256059356,0.9848
3894,1,3894,252171061,256059356,0.984815
3902,1,3902,252174963,256059356,0.98483
3917,1,3917,252178880,256059356,0.984845
3928,1,3928,252182808,256059356,0.984861
3936,1,3936,252186744,256059356,0.984876
3972,1,3972,252190716,256059356,0.984892
3982,1,3982,252194698,256059356,0.984907
3984,1,3984,252198682,256059356,0.984923
4002,1,4002,252202684,256059356,0.984938
4008,2,8016,252210700,256059356,0.98497
4012,1,4012,252214712,256059356,0.984985
4072,2,8144,252222856,256059356,0.985017
4073,1,4073,252226929,256059356,0.985033
4111,1,4111,252231040,256059356,0.985049
4114,1,4114,252235154,256059356,0.985065
4145,1,4145,252239299,256059356,0.985081
4173,1,4173,252243472,256059356,0.985098
4201,1,4201,252247673,256059356,0.985114
4219,1,4219,252251892,256059356,0.985131
4283,1,4283,252256175,256059356,0.985147
4296,1,4296,252260471,256059356,0.985164
4299,1,4299,252264770,256059356,0.985181
4431,1,4431,252269201,256059356,0.985198
4437,1,4437,252273638,256059356,0.985215
4449,1,4449,252278087,256059356,0.985233
4512,1,4512,252282599,256059356,0.98525
4574,1,4574,252287173,256059356,0.985268
4624,1,4624,252291797,256059356,0.985286
4690,1,4690,252296487,256059356,0.985305
4698,1,4698,252301185,256059356,0.985323
4712,1,4712,252305897,256059356,0.985341
4720,1,4720,252310617,256059356,0.98536
4722,1,4722,252315339,256059356,0.985378
4735,1,4735,252320074,256059356,0.985397
4816,1,4816,252324890,256059356,0.985416
4871,1,4871,252329761,256059356,0.985435
4902,1,4902,252334663,256059356,0.985454
4909,1,4909,252339572,256059356,0.985473
4951,1,4951,252344523,256059356,0.985492
4957,1,4957,252349480,256059356,0.985512
4962,1,4962,252354442,256059356,0.985531
4973,1,4973,252359415,256059356,0.98555
5103,1,5103,252364518,256059356,0.98557
5121,1,5121,252369639,256059356,0.98559
5166,1,5166,252374805,256059356,0.985611
5192,1,5192,252379997,256059356,0.985631
5269,1,5269,252385266,256059356,0.985651
5335,1,5335,252390601,256059356,0.985672
5450,1,5450,252396051,256059356,0.985694
5701,1,5701,252401752,256059356,0.985716
5705,1,5705,252407457,256059356,0.985738
5794,1,5794,252413251,256059356,0.985761
5866,1,5866,252419117,256059356,0.985784
6106,1,6106,252425223,256059356,0.985807
6185,1,6185,252431408,256059356,0.985832
6208,1,6208,252437616,256059356,0.985856
6212,1,6212,252443828,256059356,0.98588
6220,1,6220,252450048,256059356,0.985904
6221,1,6221,252456269,256059356,0.985929
6249,1,6249,252462518,256059356,0.985953
6253,1,6253,252468771,256059356,0.985978
6329,1,6329,252475100,256059356,0.986002
6480,1,6480,252481580,256059356,0.986028
6488,1,6488,252488068,256059356,0.986053
6558,1,6558,252494626,256059356,0.986079
6592,1,6592,252501218,256059356,0.986104
6690,1,6690,252507908,256059356,0.98613
6732,1,6732,252514640,256059356,0.986157
6740,1,6740,252521380,256059356,0.986183
6792,1,6792,252528172,256059356,0.98621
6876,1,6876,252535048,256059356,0.986236
6971,1,6971,252542019,256059356,0.986264
7056,1,7056,252549075,256059356,0.986291
7176,1,7176,252556251,256059356,0.986319
7185,1,7185,252563436,256059356,0.986347
7292,1,7292,252570728,256059356,0.986376
7308,1,7308,252578036,256059356,0.986404
7322,1,7322,252585358,256059356,0.986433
7374,1,7374,252592732,256059356,0.986462
7466,1,7466,252600198,256059356,0.986491
7479,1,7479,252607677,256059356,0.98652
7579,1,7579,252615256,256059356,0.98655
7586,1,7586,252622842,256059356,0.986579
7761,1,7761,252630603,256059356,0.98661
7792,1,7792,252638395,256059356,0.98664
7945,1,7945,252646340,256059356,0.986671
7999,1,7999,252654339,256059356,0.986702
8011,1,8011,252662350,256059356,0.986734
8117,1,8117,252670467,256059356,0.986765
8118,1,8118,252678585,256059356,0.986797
8126,1,8126,252686711,256059356,0.986829
8135,1,8135,252694846,256059356,0.98686
8297,1,8297,252703143,256059356,0.986893
8411,1,8411,252711554,256059356,0.986926
8423,1,8423,252719977,256059356,0.986959
8457,1,8457,252728434,256059356,0.986992
8499,1,8499,252736933,256059356,0.987025
8518,1,8518,252745451,256059356,0.987058
8554,1,8554,252754005,256059356,0.987091
8739,1,8739,252762744,256059356,0.987126
8841,1,8841,252771585,256059356,0.98716
8842,1,8842,252780427,256059356,0.987195
8923,1,8923,252789350,256059356,0.98723
9149,1,9149,252798499,256059356,0.987265
9161,1,9161,252807660,256059356,0.987301
9365,1,9365,252817025,256059356,0.987338
9417,1,9417,252826442,256059356,0.987374
9508,1,9508,252835950,256059356,0.987411
9555,1,9555,252845505,256059356,0.987449
9610,1,9610,252855115,256059356,0.987486
9816,1,9816,252864931,256059356,0.987525
9851,1,9851,252874782,256059356,0.987563
9875,1,9875,252884657,256059356,0.987602
9988,1,9988,252894645,256059356,0.987641
10034,1,10034,252904679,256059356,0.98768
10126,1,10126,252914805,256059356,0.987719
10532,1,10532,252925337,256059356,0.987761
10755,1,10755,252936092,256059356,0.987803
10922,1,10922,252947014,256059356,0.987845
10971,1,10971,252957985,256059356,0.987888
11110,1,11110,252969095,256059356,0.987931
11353,1,11353,252980448,256059356,0.987976
11419,1,11419,252991867,256059356,0.98802
11523,1,11523,253003390,256059356,0.988065
11609,1,11609,253014999,256059356,0.988111
11886,1,11886,253026885,256059356,0.988157
12320,1,12320,253039205,256059356,0.988205
12762,1,12762,253051967,256059356,0.988255
13032,1,13032,253064999,256059356,0.988306
13281,1,13281,253078280,256059356,0.988358
13368,1,13368,253091648,256059356,0.98841
13628,1,13628,253105276,256059356,0.988463
13677,1,13677,253118953,256059356,0.988517
13934,1,13934,253132887,256059356,0.988571
14336,1,14336,253147223,256059356,0.988627
14707,1,14707,253161930,256059356,0.988685
14896,1,14896,253176826,256059356,0.988743
15212,1,15212,253192038,256059356,0.988802
15338,1,15338,253207376,256059356,0.988862
15405,1,15405,253222781,256059356,0.988922
15700,1,15700,253238481,256059356,0.988984
16150,1,16150,253254631,256059356,0.989047
16279,1,16279,253270910,256059356,0.98911
16953,1,16953,253287863,256059356,0.989176
17127,1,17127,253304990,256059356,0.989243
17170,1,17170,253322160,256059356,0.98931
17390,1,17390,253339550,256059356,0.989378
17932,1,17932,253357482,256059356,0.989448
18187,1,18187,253375669,256059356,0.989519
18435,1,18435,253394104,256059356,0.989591
18452,1,18452,253412556,256059356,0.989663
18640,1,18640,253431196,256059356,0.989736
18785,1,18785,253449981,256059356,0.989809
19013,1,19013,253468994,256059356,0.989884
19368,1,19368,253488362,256059356,0.989959
19943,1,19943,253508305,256059356,0.990037
19989,1,19989,253528294,256059356,0.990115
20763,1,20763,253549057,256059356,0.990196
20855,1,20855,253569912,256059356,0.990278
21585,1,21585,253591497,256059356,0.990362
21932,1,21932,253613429,256059356,0.990448
22190,1,22190,253635619,256059356,0.990534
23740,1,23740,253659359,256059356,0.990627
24543,1,24543,253683902,256059356,0.990723
25114,1,25114,253709016,256059356,0.990821
26434,1,26434,253735450,256059356,0.990924
26832,1,26832,253762282,256059356,0.991029
29353,1,29353,253791635,256059356,0.991144
29758,1,29758,253821393,256059356,0.99126
30702,1,30702,253852095,256059356,0.99138
32584,1,32584,253884679,256059356,0.991507
32714,1,32714,253917393,256059356,0.991635
34443,1,34443,253951836,256059356,0.991769
35921,1,35921,253987757,256059356,0.99191
36126,1,36126,254023883,256059356,0.992051
38668,1,38668,254062551,256059356,0.992202
39866,1,39866,254102417,256059356,0.992357
40389,1,40389,254142806,256059356,0.992515
40944,1,40944,254183750,256059356,0.992675
40985,1,40985,254224735,256059356,0.992835
42192,1,42192,254266927,256059356,0.993
43358,1,43358,254310285,256059356,0.993169
44953,1,44953,254355238,256059356,0.993345
47648,1,47648,254402886,256059356,0.993531
49877,1,49877,254452763,256059356,0.993726
53149,1,53149,254505912,256059356,0.993933
53679,1,53679,254559591,256059356,0.994143
53829,1,53829,254613420,256059356,0.994353
54838,1,54838,254668258,256059356,0.994567
64699,1,64699,254732957,256059356,0.99482
66082,1,66082,254799039,256059356,0.995078
66643,1,66643,254865682,256059356,0.995338
69241,1,69241,254934923,256059356,0.995609
76465,2,152930,255087853,256059356,0.996206
83780,1,83780,255171633,256059356,0.996533
84173,1,84173,255255806,256059356,0.996862
90470,1,90470,255346276,256059356,0.997215
102673,1,102673,255448949,256059356,0.997616
115617,1,115617,255564566,256059356,0.998068
134602,1,134602,255699168,256059356,0.998593
167536,1,167536,255866704,256059356,0.999248
192652,1,192652,256059356,256059356,1
