1,6510314,6510314,6510314,256059356,0.025425
2,3468687,6937374,13447688,256059356,0.0525179
3,8295184,24885552,38333240,256059356,0.149705
4,4572545,18290180,56623420,256059356,0.221134
5,7385381,36926905,93550325,256059356,0.365346
6,1404392,8426352,101976677,256059356,0.398254
7,778232,5447624,107424301,256059356,0.419529
8,828215,6625720,114050021,256059356,0.445405
9,465104,4185936,118235957,256059356,0.461752
10,307023,3070230,121306187,256059356,0.473742
11,245885,2704735,124010922,256059356,0.484305
12,166859,2002308,126013230,256059356,0.492125
13,126734,1647542,127660772,256059356,0.498559
14,141413,1979782,129640554,256059356,0.506291
15,109799,1646985,131287539,256059356,0.512723
16,98622,1577952,132865491,256059356,0.518886
17,81523,1385891,134251382,256059356,0.524298
18,81361,1464498,135715880,256059356,0.530017
19,72050,1368950,137084830,256059356,0.535363
20,76338,1526760,138611590,256059356,0.541326
21,61203,1285263,139896853,256059356,0.546345
22,58052,1277144,141173997,256059356,0.551333
23,56621,1302283,142476280,256059356,0.556419
24,40516,972384,143448664,256059356,0.560216
25,33170,829250,144277914,256059356,0.563455
26,30995,805870,145083784,256059356,0.566602
27,26367,711909,145795693,256059356,0.569382
28,24643,690004,146485697,256059356,0.572077
29,23384,678136,147163833,256059356,0.574725
30,22833,684990,147848823,256059356,0.577401
31,21494,666314,148515137,256059356,0.580003
32,18969,607008,149122145,256059356,0.582373
33,18455,609015,149731160,256059356,0.584752
34,16762,569908,150301068,256059356,0.586977
35,15701,549535,150850603,256059356,0.589124
36,14650,527400,151378003,256059356,0.591183
37,13621,503977,151881980,256059356,0.593151
38,12792,486096,152368076,256059356,0.59505
39,11766,458874,152826950,256059356,0.596842
40,11139,445560,153272510,256059356,0.598582
41,13767,564447,153836957,256059356,0.600786
42,9701,407442,154244399,256059356,0.602378
43,9608,413144,154657543,256059356,0.603991
44,9259,407396,155064939,256059356,0.605582
45,9148,411660,155476599,256059356,0.60719
46,8461,389206,155865805,256059356,0.60871
47,8515,400205,156266010,256059356,0.610273
48,8149,391152,156657162,256059356,0.6118
49,7403,362747,157019909,256059356,0.613217
50,8319,415950,157435859,256059356,0.614841
51,7767,396117,157831976,256059356,0.616388
52,7134,370968,158202944,256059356,0.617837
53,7713,408789,158611733,256059356,0.619433
54,7808,421632,159033365,256059356,0.62108
55,7128,392040,159425405,256059356,0.622611
56,6352,355712,159781117,256059356,0.624
57,13189,751773,160532890,256059356,0.626936
58,5410,313780,160846670,256059356,0.628162
59,5589,329751,161176421,256059356,0.629449
60,5564,333840,161510261,256059356,0.630753
61,4860,296460,161806721,256059356,0.631911
62,6058,375596,162182317,256059356,0.633378
63,5086,320418,162502735,256059356,0.634629
64,4572,292608,162795343,256059356,0.635772
65,5036,327340,163122683,256059356,0.63705
66,6803,448998,163571681,256059356,0.638804
67,4695,314565,163886246,256059356,0.640032
68,4885,332180,164218426,256059356,0.64133
69,6898,475962,164694388,256059356,0.643188
70,4500,315000,165009388,256059356,0.644419
71,4966,352586,165361974,256059356,0.645795
72,6254,450288,165812262,256059356,0.647554
73,4111,300103,166112365,256059356,0.648726
74,4874,360676,166473041,256059356,0.650135
75,5331,399825,166872866,256059356,0.651696
76,3916,297616,167170482,256059356,0.652858
77,4944,380688,167551170,256059356,0.654345
78,5620,438360,167989530,256059356,0.656057
79,4982,393578,168383108,256059356,0.657594
80,4157,332560,168715668,256059356,0.658893
81,4660,377460,169093128,256059356,0.660367
82,4430,363260,169456388,256059356,0.661786
83,4310,357730,169814118,256059356,0.663183
84,7904,663936,170478054,256059356,0.665776
85,4091,347735,170825789,256059356,0.667134
86,4962,426732,171252521,256059356,0.6688
87,7570,658590,171911111,256059356,0.671372
88,4661,410168,172321279,256059356,0.672974
89,4847,431383,172752662,256059356,0.674659
90,7590,683100,173435762,256059356,0.677326
91,4623,420693,173856455,256059356,0.678969
92,4942,454664,174311119,256059356,0.680745
93,7267,675831,174986950,256059356,0.683384
94,4468,419992,175406942,256059356,0.685025
95,5850,555750,175962692,256059356,0.687195
96,5868,563328,176526020,256059356,0.689395
97,3782,366854,176892874,256059356,0.690828
98,5288,518224,177411098,256059356,0.692851
99,4977,492723,177903821,256059356,0.694776
100,3737,373700,178277521,256059356,0.696235
101,4060,410060,178687581,256059356,0.697837
102,4377,446454,179134035,256059356,0.69958
103,3523,362869,179496904,256059356,0.700997
104,3829,398216,179895120,256059356,0.702552
105,3978,417690,180312810,256059356,0.704184
106,3411,361566,180674376,256059356,0.705596
107,3564,381348,181055724,256059356,0.707085
108,3699,399492,181455216,256059356,0.708645
109,3156,344004,181799220,256059356,0.709989
110,3445,378950,182178170,256059356,0.711469
111,3312,367632,182545802,256059356,0.712904
112,3076,344512,182890314,256059356,0.71425
113,3263,368719,183259033,256059356,0.71569
114,3186,363204,183622237,256059356,0.717108
115,2821,324415,183946652,256059356,0.718375
116,3038,352408,184299060,256059356,0.719751
117,2940,343980,184643040,256059356,0.721095
118,2632,310576,184953616,256059356,0.722308
119,2731,324989,185278605,256059356,0.723577
120,2649,317880,185596485,256059356,0.724818
121,2537,306977,185903462,256059356,0.726017
122,2563,312686,186216148,256059356,0.727238
123,2149,264327,186480475,256059356,0.72827
124,1964,243536,186724011,256059356,0.729222
125,1920,240000,186964011,256059356,0.730159
126,1835,231210,187195221,256059356,0.731062
127,1760,223520,187418741,256059356,0.731935
128,1802,230656,187649397,256059356,0.732836
129,1751,225879,187875276,256059356,0.733718
130,1743,226590,188101866,256059356,0.734603
131,1859,243529,188345395,256059356,0.735554
132,1852,244464,188589859,256059356,0.736508
133,1740,231420,188821279,256059356,0.737412
134,1805,241870,189063149,256059356,0.738357
135,1726,233010,189296159,256059356,0.739267
136,1654,224944,189521103,256059356,0.740145
137,1515,207555,189728658,256059356,0.740956
138,1682,232116,189960774,256059356,0.741862
139,1657,230323,190191097,256059356,0.742762
140,1565,219100,190410197,256059356,0.743617
141,1656,233496,190643693,256059356,0.744529
142,1465,208030,190851723,256059356,0.745342
143,1501,214643,191066366,256059356,0.74618
144,1555,223920,191290286,256059356,0.747054
145,1415,205175,191495461,256059356,0.747856
146,1424,207904,191703365,256059356,0.748668
147,1405,206535,191909900,256059356,0.749474
148,1309,193732,192103632,256059356,0.750231
149,1392,207408,192311040,256059356,0.751041
150,1352,202800,192513840,256059356,0.751833
151,1247,188297,192702137,256059356,0.752568
152,1325,201400,192903537,256059356,0.753355
153,1246,190638,193094175,256059356,0.754099
154,1192,183568,193277743,256059356,0.754816
155,1214,188170,193465913,256059356,0.755551
156,1137,177372,193643285,256059356,0.756244
157,1068,167676,193810961,256059356,0.756899
158,1122,177276,193988237,256059356,0.757591
159,1041,165519,194153756,256059356,0.758237
160,1032,165120,194318876,256059356,0.758882
161,1035,166635,194485511,256059356,0.759533
162,1018,164916,194650427,256059356,0.760177
163,958,156154,194806581,256059356,0.760787
164,974,159736,194966317,256059356,0.761411
165,939,154935,195121252,256059356,0.762016
166,919,152554,195273806,256059356,0.762611
167,927,154809,195428615,256059356,0.763216
168,947,159096,195587711,256059356,0.763837
169,883,149227,195736938,256059356,0.76442
170,883,150110,195887048,256059356,0.765006
171,855,146205,196033253,256059356,0.765577
172,879,151188,196184441,256059356,0.766168
173,888,153624,196338065,256059356,0.766768
174,841,146334,196484399,256059356,0.767339
175,852,149100,196633499,256059356,0.767922
176,912,160512,196794011,256059356,0.768548
177,838,148326,196942337,256059356,0.769128
178,924,164472,197106809,256059356,0.76977
179,875,156625,197263434,256059356,0.770382
180,747,134460,197397894,256059356,0.770907
181,980,177380,197575274,256059356,0.7716
182,897,163254,197738528,256059356,0.772237
183,855,156465,197894993,256059356,0.772848
184,970,178480,198073473,256059356,0.773545
185,781,144485,198217958,256059356,0.774109
186,787,146382,198364340,256059356,0.774681
187,929,173723,198538063,256059356,0.77536
188,827,155476,198693539,256059356,0.775967
189,812,153468,198847007,256059356,0.776566
190,961,182590,199029597,256059356,0.777279
191,781,149171,199178768,256059356,0.777862
192,750,144000,199322768,256059356,0.778424
193,1028,198404,199521172,256059356,0.779199
194,754,146276,199667448,256059356,0.77977
195,713,139035,199806483,256059356,0.780313
196,873,171108,199977591,256059356,0.780981
197,779,153463,200131054,256059356,0.781581
198,5209,1031382,201162436,256059356,0.785609
199,768,152832,201315268,256059356,0.786205
200,752,150400,201465668,256059356,0.786793
201,876,176076,201641744,256059356,0.78748
202,751,151702,201793446,256059356,0.788073
203,952,193256,201986702,256059356,0.788828
204,754,153816,202140518,256059356,0.789428
205,795,162975,202303493,256059356,0.790065
206,703,144818,202448311,256059356,0.79063
207,683,141381,202589692,256059356,0.791183
208,687,142896,202732588,256059356,0.791741
209,664,138776,202871364,256059356,0.792283
210,651,136710,203008074,256059356,0.792816
211,1186,250246,203258320,256059356,0.793794
212,714,151368,203409688,256059356,0.794385
213,683,145479,203555167,256059356,0.794953
214,649,138886,203694053,256059356,0.795495
215,613,131795,203825848,256059356,0.79601
216,673,145368,203971216,256059356,0.796578
217,593,128681,204099897,256059356,0.79708
218,645,140610,204240507,256059356,0.79763
219,610,133590,204374097,256059356,0.798151
220,581,127820,204501917,256059356,0.79865
221,623,137683,204639600,256059356,0.799188
222,765,169830,204809430,256059356,0.799851
223,744,165912,204975342,256059356,0.800499
224,628,140672,205116014,256059356,0.801049
225,660,148500,205264514,256059356,0.801629
226,598,135148,205399662,256059356,0.802156
227,540,122580,205522242,256059356,0.802635
228,581,132468,205654710,256059356,0.803152
229,605,138545,205793255,256059356,0.803694
230,571,131330,205924585,256059356,0.804206
231,534,123354,206047939,256059356,0.804688
232,512,118784,206166723,256059356,0.805152
233,489,113937,206280660,256059356,0.805597
234,547,127998,206408658,256059356,0.806097
235,500,117500,206526158,256059356,0.806556
236,522,123192,206649350,256059356,0.807037
237,536,127032,206776382,256059356,0.807533
238,530,126140,206902522,256059356,0.808026
239,550,131450,207033972,256059356,0.808539
240,503,120720,207154692,256059356,0.80901
241,682,164362,207319054,256059356,0.809652
242,571,138182,207457236,256059356,0.810192
243,578,140454,207597690,256059356,0.81074
244,569,138836,207736526,256059356,0.811283
245,557,136465,207872991,256059356,0.811816
246,578,142188,208015179,256059356,0.812371
247,648,160056,208175235,256059356,0.812996
248,578,143344,208318579,256059356,0.813556
249,588,146412,208464991,256059356,0.814128
250,561,140250,208605241,256059356,0.814675
251,570,143070,208748311,256059356,0.815234
252,594,149688,208897999,256059356,0.815819
253,581,146993,209044992,256059356,0.816393
254,562,142748,209187740,256059356,0.81695
255,589,150195,209337935,256059356,0.817537
256,596,152576,209490511,256059356,0.818133
257,525,134925,209625436,256059356,0.81866
258,557,143706,209769142,256059356,0.819221
259,642,166278,209935420,256059356,0.81987
260,551,143260,210078680,256059356,0.82043
261,644,168084,210246764,256059356,0.821086
262,643,168466,210415230,256059356,0.821744
263,534,140442,210555672,256059356,0.822292
264,555,146520,210702192,256059356,0.822865
265,634,168010,210870202,256059356,0.823521
266,532,141512,211011714,256059356,0.824073
267,558,148986,211160700,256059356,0.824655
268,596,159728,211320428,256059356,0.825279
269,537,144453,211464881,256059356,0.825843
270,549,148230,211613111,256059356,0.826422
271,564,152844,211765955,256059356,0.827019
272,513,139536,211905491,256059356,0.827564
273,520,141960,212047451,256059356,0.828118
274,512,140288,212187739,256059356,0.828666
275,489,134475,212322214,256059356,0.829191
276,483,133308,212455522,256059356,0.829712
277,437,121049,212576571,256059356,0.830185
278,455,126490,212703061,256059356,0.830679
279,449,125271,212828332,256059356,0.831168
280,473,132440,212960772,256059356,0.831685
281,470,132070,213092842,256059356,0.832201
282,503,141846,213234688,256059356,0.832755
283,436,123388,213358076,256059356,0.833237
284,437,124108,213482184,256059356,0.833721
285,459,130815,213612999,256059356,0.834232
286,401,114686,213727685,256059356,0.83468
287,411,117957,213845642,256059356,0.835141
288,457,131616,213977258,256059356,0.835655
289,389,112421,214089679,256059356,0.836094
290,422,122380,214212059,256059356,0.836572
291,447,130077,214342136,256059356,0.83708
292,365,106580,214448716,256059356,0.837496
293,438,128334,214577050,256059356,0.837997
294,474,139356,214716406,256059356,0.838542
295,372,109740,214826146,256059356,0.83897
296,535,158360,214984506,256059356,0.839589
297,444,131868,215116374,256059356,0.840104
298,432,128736,215245110,256059356,0.840606
299,583,174317,215419427,256059356,0.841287
300,493,147900,215567327,256059356,0.841865
301,362,108962,215676289,256059356,0.84229
302,612,184824,215861113,256059356,0.843012
303,464,140592,216001705,256059356,0.843561
304,638,193952,216195657,256059356,0.844319
305,704,214720,216410377,256059356,0.845157
306,489,149634,216560011,256059356,0.845741
307,1010,310070,216870081,256059356,0.846952
308,614,189112,217059193,256059356,0.847691
309,479,148011,217207204,256059356,0.848269
310,535,165850,217373054,256059356,0.848917
311,585,181935,217554989,256059356,0.849627
312,458,142896,217697885,256059356,0.850185
313,444,138972,217836857,256059356,0.850728
314,524,164536,218001393,256059356,0.851371
315,456,143640,218145033,256059356,0.851932
316,380,120080,218265113,256059356,0.8524
317,613,194321,218459434,256059356,0.853159
318,405,128790,218588224,256059356,0.853662
319,319,101761,218689985,256059356,0.85406
320,570,182400,218872385,256059356,0.854772
321,483,155043,219027428,256059356,0.855378
322,357,114954,219142382,256059356,0.855826
323,546,176358,219318740,256059356,0.856515
324,518,167832,219486572,256059356,0.857171
325,399,129675,219616247,256059356,0.857677
326,482,157132,219773379,256059356,0.858291
327,481,157287,219930666,256059356,0.858905
328,361,118408,220049074,256059356,0.859367
329,384,126336,220175410,256059356,0.859861
330,486,160380,220335790,256059356,0.860487
331,452,149612,220485402,256059356,0.861071
332,354,117528,220602930,256059356,0.86153
333,400,133200,220736130,256059356,0.862051
334,479,159986,220896116,256059356,0.862675
335,364,121940,221018056,256059356,0.863152
336,338,113568,221131624,256059356,0.863595
337,335,112895,221244519,256059356,0.864036
338,331,111878,221356397,256059356,0.864473
339,325,110175,221466572,256059356,0.864903
340,295,100300,221566872,256059356,0.865295
341,299,101959,221668831,256059356,0.865693
342,324,110808,221779639,256059356,0.866126
343,324,111132,221890771,256059356,0.86656
344,308,105952,221996723,256059356,0.866974
345,342,117990,222114713,256059356,0.867434
346,296,102416,222217129,256059356,0.867834
347,352,122144,222339273,256059356,0.868311
348,322,112056,222451329,256059356,0.868749
349,321,112029,222563358,256059356,0.869187
350,359,125650,222689008,256059356,0.869677
351,379,133029,222822037,256059356,0.870197
352,396,139392,222961429,256059356,0.870741
353,345,121785,223083214,256059356,0.871217
354,470,166380,223249594,256059356,0.871867
355,399,141645,223391239,256059356,0.87242
356,438,155928,223547167,256059356,0.873029
357,491,175287,223722454,256059356,0.873713
358,440,157520,223879974,256059356,0.874328
359,447,160473,224040447,256059356,0.874955
360,490,176400,224216847,256059356,0.875644
361,475,171475,224388322,256059356,0.876314
362,477,172674,224560996,256059356,0.876988
363,495,179685,224740681,256059356,0.87769
364,533,194012,224934693,256059356,0.878447
365,493,179945,225114638,256059356,0.87915
366,519,189954,225304592,256059356,0.879892
367,541,198547,225503139,256059356,0.880667
368,481,177008,225680147,256059356,0.881359
369,530,195570,225875717,256059356,0.882122
370,501,185370,226061087,256059356,0.882846
371,526,195146,226256233,256059356,0.883609
372,520,193440,226449673,256059356,0.884364
373,514,191722,226641395,256059356,0.885113
374,497,185878,226827273,256059356,0.885839
375,545,204375,227031648,256059356,0.886637
376,513,192888,227224536,256059356,0.88739
377,508,191516,227416052,256059356,0.888138
378,519,196182,227612234,256059356,0.888904
379,455,172445,227784679,256059356,0.889578
380,437,166060,227950739,256059356,0.890226
381,475,180975,228131714,256059356,0.890933
382,387,147834,228279548,256059356,0.89151
383,430,164690,228444238,256059356,0.892153
384,434,166656,228610894,256059356,0.892804
385,410,157850,228768744,256059356,0.893421
386,391,150926,228919670,256059356,0.89401
387,389,150543,229070213,256059356,0.894598
388,370,143560,229213773,256059356,0.895159
389,345,134205,229347978,256059356,0.895683
390,358,139620,229487598,256059356,0.896228
391,405,158355,229645953,256059356,0.896847
392,375,147000,229792953,256059356,0.897421
393,349,137157,229930110,256059356,0.897956
394,344,135536,230065646,256059356,0.898486
395,332,131140,230196786,256059356,0.898998
396,312,123552,230320338,256059356,0.89948
397,299,118703,230439041,256059356,0.899944
398,311,123778,230562819,256059356,0.900427
399,300,119700,230682519,256059356,0.900895
400,265,106000,230788519,256059356,0.901309
401,261,104661,230893180,256059356,0.901717
402,290,116580,231009760,256059356,0.902173
403,242,97526,231107286,256059356,0.902554
404,229,92516,231199802,256059356,0.902915
405,227,91935,231291737,256059356,0.903274
406,274,111244,231402981,256059356,0.903708
407,197,80179,231483160,256059356,0.904021
408,220,89760,231572920,256059356,0.904372
409,225,92025,231664945,256059356,0.904731
410,193,79130,231744075,256059356,0.90504
411,229,94119,231838194,256059356,0.905408
412,182,74984,231913178,256059356,0.905701
413,187,77231,231990409,256059356,0.906002
414,203,84042,232074451,256059356,0.906331
415,176,73040,232147491,256059356,0.906616
416,188,78208,232225699,256059356,0.906921
417,161,67137,232292836,256059356,0.907184
418,155,64790,232357626,256059356,0.907437
419,164,68716,232426342,256059356,0.907705
420,157,65940,232492282,256059356,0.907962
421,143,60203,232552485,256059356,0.908198
422,151,63722,232616207,256059356,0.908446
423,152,64296,232680503,256059356,0.908698
424,117,49608,232730111,256059356,0.908891
425,125,53125,232783236,256059356,0.909099
426,141,60066,232843302,256059356,0.909333
427,137,58499,232901801,256059356,0.909562
428,125,53500,232955301,256059356,0.909771
429,133,57057,233012358,256059356,0.909994
430,129,55470,233067828,256059356,0.91021
431,107,46117,233113945,256059356,0.91039
432,108,46656,233160601,256059356,0.910572
433,113,48929,233209530,256059356,0.910764
434,117,50778,233260308,256059356,0.910962
435,98,42630,233302938,256059356,0.911128
436,99,43164,233346102,256059356,0.911297
437,88,38456,233384558,256059356,0.911447
438,92,40296,233424854,256059356,0.911604
439,90,39510,233464364,256059356,0.911759
440,99,43560,233507924,256059356,0.911929
441,88,38808,233546732,256059356,0.91208
442,91,40222,233586954,256059356,0.912238
443,92,40756,233627710,256059356,0.912397
444,81,35964,233663674,256059356,0.912537
445,82,36490,233700164,256059356,0.91268
446,88,39248,233739412,256059356,0.912833
447,86,38442,233777854,256059356,0.912983
448,90,40320,233818174,256059356,0.913141
449,97,43553,233861727,256059356,0.913311
450,91,40950,233902677,256059356,0.913471
451,100,45100,233947777,256059356,0.913647
452,85,38420,233986197,256059356,0.913797
453,91,41223,234027420,256059356,0.913958
454,84,38136,234065556,256059356,0.914107
455,88,40040,234105596,256059356,0.914263
456,71,32376,234137972,256059356,0.914389
457,86,39302,234177274,256059356,0.914543
458,69,31602,234208876,256059356,0.914666
459,72,33048,234241924,256059356,0.914795
460,79,36340,234278264,256059356,0.914937
461,54,24894,234303158,256059356,0.915035
462,72,33264,234336422,256059356,0.915164
463,74,34262,234370684,256059356,0.915298
464,90,41760,234412444,256059356,0.915461
465,72,33480,234445924,256059356,0.915592
466,86,40076,234486000,256059356,0.915749
467,100,46700,234532700,256059356,0.915931
468,107,50076,234582776,256059356,0.916127
469,108,50652,234633428,256059356,0.916324
470,61,28670,234662098,256059356,0.916436
471,65,30615,234692713,256059356,0.916556
472,74,34928,234727641,256059356,0.916692
473,102,48246,234775887,256059356,0.916881
474,80,37920,234813807,256059356,0.917029
475,64,30400,234844207,256059356,0.917148
476,76,36176,234880383,256059356,0.917289
477,72,34344,234914727,256059356,0.917423
478,60,28680,234943407,256059356,0.917535
479,56,26824,234970231,256059356,0.91764
480,57,27360,234997591,256059356,0.917747
481,64,30784,235028375,256059356,0.917867
482,56,26992,235055367,256059356,0.917972
483,74,35742,235091109,256059356,0.918112
484,75,36300,235127409,256059356,0.918254
485,65,31525,235158934,256059356,0.918377
486,76,36936,235195870,256059356,0.918521
487,65,31655,235227525,256059356,0.918645
488,65,31720,235259245,256059356,0.918768
489,63,30807,235290052,256059356,0.918889
490,82,40180,235330232,256059356,0.919046
491,73,35843,235366075,256059356,0.919186
492,62,30504,235396579,256059356,0.919305
493,74,36482,235433061,256059356,0.919447
494,71,35074,235468135,256059356,0.919584
495,57,28215,235496350,256059356,0.919694
496,54,26784,235523134,256059356,0.919799
497,47,23359,235546493,256059356,0.91989
498,59,29382,235575875,256059356,0.920005
499,59,29441,235605316,256059356,0.92012
500,55,27500,235632816,256059356,0.920227
501,59,29559,235662375,256059356,0.920343
502,67,33634,235696009,256059356,0.920474
503,52,26156,235722165,256059356,0.920576
504,50,25200,235747365,256059356,0.920675
505,41,20705,235768070,256059356,0.920756
506,54,27324,235795394,256059356,0.920862
507,41,20787,235816181,256059356,0.920943
508,45,22860,235839041,256059356,0.921033
509,55,27995,235867036,256059356,0.921142
510,54,27540,235894576,256059356,0.92125
511,42,21462,235916038,256059356,0.921333
512,39,19968,235936006,256059356,0.921411
513,55,28215,235964221,256059356,0.921522
514,59,30326,235994547,256059356,0.92164
515,66,33990,236028537,256059356,0.921773
516,43,22188,236050725,256059356,0.921859
517,45,23265,236073990,256059356,0.92195
518,40,20720,236094710,256059356,0.922031
519,47,24393,236119103,256059356,0.922126
520,54,28080,236147183,256059356,0.922236
521,52,27092,236174275,256059356,0.922342
522,50,26100,236200375,256059356,0.922444
523,58,30334,236230709,256059356,0.922562
524,39,20436,236251145,256059356,0.922642
525,35,18375,236269520,256059356,0.922714
526,51,26826,236296346,256059356,0.922819
527,44,23188,236319534,256059356,0.922909
528,33,17424,236336958,256059356,0.922977
529,61,32269,236369227,256059356,0.923103
530,54,28620,236397847,256059356,0.923215
531,47,24957,236422804,256059356,0.923312
532,49,26068,236448872,256059356,0.923414
533,43,22919,236471791,256059356,0.923504
534,40,21360,236493151,256059356,0.923587
535,59,31565,236524716,256059356,0.923711
536,46,24656,236549372,256059356,0.923807
537,41,22017,236571389,256059356,0.923893
538,67,36046,236607435,256059356,0.924034
539,50,26950,236634385,256059356,0.924139
540,56,30240,236664625,256059356,0.924257
541,70,37870,236702495,256059356,0.924405
542,43,23306,236725801,256059356,0.924496
543,38,20634,236746435,256059356,0.924576
544,72,39168,236785603,256059356,0.924729
545,35,19075,236804678,256059356,0.924804
546,46,25116,236829794,256059356,0.924902
547,64,35008,236864802,256059356,0.925039
548,23,12604,236877406,256059356,0.925088
549,41,22509,236899915,256059356,0.925176
550,64,35200,236935115,256059356,0.925313
551,39,21489,236956604,256059356,0.925397
552,38,20976,236977580,256059356,0.925479
553,45,24885,237002465,256059356,0.925576
554,50,27700,237030165,256059356,0.925684
555,40,22200,237052365,256059356,0.925771
556,47,26132,237078497,256059356,0.925873
557,37,20609,237099106,256059356,0.925954
558,38,21204,237120310,256059356,0.926037
559,50,27950,237148260,256059356,0.926146
560,44,24640,237172900,256059356,0.926242
561,34,19074,237191974,256059356,0.926316
562,59,33158,237225132,256059356,0.926446
563,30,16890,237242022,256059356,0.926512
564,33,18612,237260634,256059356,0.926585
565,49,27685,237288319,256059356,0.926693
566,39,22074,237310393,256059356,0.926779
567,34,19278,237329671,256059356,0.926854
568,38,21584,237351255,256059356,0.926938
569,50,28450,237379705,256059356,0.92705
570,39,22230,237401935,256059356,0.927136
571,54,30834,237432769,256059356,0.927257
572,37,21164,237453933,256059356,0.927339
573,35,20055,237473988,256059356,0.927418
574,43,24682,237498670,256059356,0.927514
575,40,23000,237521670,256059356,0.927604
576,45,25920,237547590,256059356,0.927705
577,34,19618,237567208,256059356,0.927782
578,38,21964,237589172,256059356,0.927868
579,38,22002,237611174,256059356,0.927953
580,44,25520,237636694,256059356,0.928053
581,44,25564,237662258,256059356,0.928153
582,33,19206,237681464,256059356,0.928228
583,36,20988,237702452,256059356,0.92831
584,35,20440,237722892,256059356,0.92839
585,29,16965,237739857,256059356,0.928456
586,35,20510,237760367,256059356,0.928536
587,35,20545,237780912,256059356,0.928616
588,36,21168,237802080,256059356,0.928699
589,31,18259,237820339,256059356,0.92877
590,38,22420,237842759,256059356,0.928858
591,31,18321,237861080,256059356,0.928929
592,34,20128,237881208,256059356,0.929008
593,24,14232,237895440,256059356,0.929064
594,33,19602,237915042,256059356,0.92914
595,42,24990,237940032,256059356,0.929238
596,32,19072,237959104,256059356,0.929312
597,35,20895,237979999,256059356,0.929394
598,40,23920,238003919,256059356,0.929487
599,29,17371,238021290,256059356,0.929555
600,32,19200,238040490,256059356,0.92963
601,34,20434,238060924,256059356,0.92971
602,33,19866,238080790,256059356,0.929788
603,41,24723,238105513,256059356,0.929884
604,37,22348,238127861,256059356,0.929971
605,20,12100,238139961,256059356,0.930019
606,28,16968,238156929,256059356,0.930085
607,38,23066,238179995,256059356,0.930175
608,30,18240,238198235,256059356,0.930246
609,28,17052,238215287,256059356,0.930313
610,41,25010,238240297,256059356,0.93041
611,29,17719,238258016,256059356,0.93048
612,33,20196,238278212,256059356,0.930559
613,41,25133,238303345,256059356,0.930657
614,26,15964,238319309,256059356,0.930719
615,37,22755,238342064,256059356,0.930808
616,30,18480,238360544,256059356,0.93088
617,23,14191,238374735,256059356,0.930935
618,31,19158,238393893,256059356,0.93101
619,35,21665,238415558,256059356,0.931095
620,20,12400,238427958,256059356,0.931143
621,24,14904,238442862,256059356,0.931202
622,28,17416,238460278,256059356,0.93127
623,28,17444,238477722,256059356,0.931338
624,27,16848,238494570,256059356,0.931403
625,28,17500,238512070,256059356,0.931472
626,28,17528,238529598,256059356,0.93154
627,31,19437,238549035,256059356,0.931616
628,36,22608,238571643,256059356,0.931704
629,15,9435,238581078,256059356,0.931741
630,21,13230,238594308,256059356,0.931793
631,27,17037,238611345,256059356,0.93186
632,30,18960,238630305,256059356,0.931934
633,20,12660,238642965,256059356,0.931983
634,33,20922,238663887,256059356,0.932065
635,22,13970,238677857,256059356,0.932119
636,29,18444,238696301,256059356,0.932191
637,26,16562,238712863,256059356,0.932256
638,26,16588,238729451,256059356,0.932321
639,26,16614,238746065,256059356,0.932386
640,19,12160,238758225,256059356,0.932433
641,28,17948,238776173,256059356,0.932503
642,30,19260,238795433,256059356,0.932578
643,22,14146,238809579,256059356,0.932634
644,29,18676,238828255,256059356,0.932707
645,29,18705,238846960,256059356,0.93278
646,17,10982,238857942,256059356,0.932823
647,37,23939,238881881,256059356,0.932916
648,16,10368,238892249,256059356,0.932957
649,36,23364,238915613,256059356,0.933048
650,22,14300,238929913,256059356,0.933104
651,22,14322,238944235,256059356,0.93316
652,29,18908,238963143,256059356,0.933233
653,24,15672,238978815,256059356,0.933295
654,32,20928,238999743,256059356,0.933376
655,26,17030,239016773,256059356,0.933443
656,23,15088,239031861,256059356,0.933502
657,27,17739,239049600,256059356,0.933571
658,11,7238,239056838,256059356,0.933599
659,27,17793,239074631,256059356,0.933669
660,22,14520,239089151,256059356,0.933726
661,23,15203,239104354,256059356,0.933785
662,20,13240,239117594,256059356,0.933837
663,21,13923,239131517,256059356,0.933891
664,19,12616,239144133,256059356,0.93394
665,24,15960,239160093,256059356,0.934003
666,22,14652,239174745,256059356,0.93406
667,29,19343,239194088,256059356,0.934135
668,25,16700,239210788,256059356,0.934201
669,19,12711,239223499,256059356,0.93425
670,21,14070,239237569,256059356,0.934305
671,18,12078,239249647,256059356,0.934352
672,10,6720,239256367,256059356,0.934379
673,22,14806,239271173,256059356,0.934436
674,20,13480,239284653,256059356,0.934489
675,16,10800,239295453,256059356,0.934531
676,23,15548,239311001,256059356,0.934592
677,15,10155,239321156,256059356,0.934632
678,18,12204,239333360,256059356,0.934679
679,26,17654,239351014,256059356,0.934748
680,16,10880,239361894,256059356,0.934791
681,16,10896,239372790,256059356,0.934833
682,25,17050,239389840,256059356,0.9349
683,16,10928,239400768,256059356,0.934942
684,14,9576,239410344,256059356,0.93498
685,23,15755,239426099,256059356,0.935041
686,24,16464,239442563,256059356,0.935106
687,24,16488,239459051,256059356,0.93517
688,24,16512,239475563,256059356,0.935235
689,11,7579,239483142,256059356,0.935264
690,16,11040,239494182,256059356,0.935307
691,23,15893,239510075,256059356,0.935369
692,17,11764,239521839,256059356,0.935415
693,19,13167,239535006,256059356,0.935467
694,20,13880,239548886,256059356,0.935521
695,10,6950,239555836,256059356,0.935548
696,17,11832,239567668,256059356,0.935594
697,17,11849,239579517,256059356,0.935641
698,17,11866,239591383,256059356,0.935687
699,13,9087,239600470,256059356,0.935722
700,13,9100,239609570,256059356,0.935758
701,12,8412,239617982,256059356,0.935791
702,15,10530,239628512,256059356,0.935832
703,15,10545,239639057,256059356,0.935873
704,15,10560,239649617,256059356,0.935914
705,19,13395,239663012,256059356,0.935967
706,16,11296,239674308,256059356,0.936011
707,13,9191,239683499,256059356,0.936047
708,16,11328,239694827,256059356,0.936091
709,20,14180,239709007,256059356,0.936146
710,13,9230,239718237,256059356,0.936182
711,16,11376,239729613,256059356,0.936227
712,16,11392,239741005,256059356,0.936271
713,12,8556,239749561,256059356,0.936305
714,16,11424,239760985,256059356,0.936349
715,16,11440,239772425,256059356,0.936394
716,23,16468,239788893,256059356,0.936458
717,16,11472,239800365,256059356,0.936503
718,17,12206,239812571,256059356,0.936551
719,12,8628,239821199,256059356,0.936584
720,27,19440,239840639,256059356,0.93666
721,42,30282,239870921,256059356,0.936779
722,29,20938,239891859,256059356,0.93686
723,27,19521,239911380,256059356,0.936937
724,19,13756,239925136,256059356,0.93699
725,18,13050,239938186,256059356,0.937041
726,67,48642,239986828,256059356,0.937231
727,16,11632,239998460,256059356,0.937277
728,25,18200,240016660,256059356,0.937348
729,41,29889,240046549,256059356,0.937464
730,27,19710,240066259,256059356,0.937541
731,29,21199,240087458,256059356,0.937624
732,43,31476,240118934,256059356,0.937747
733,40,29320,240148254,256059356,0.937862
734,24,17616,240165870,256059356,0.93793
735,37,27195,240193065,256059356,0.938037
736,32,23552,240216617,256059356,0.938129
737,24,17688,240234305,256059356,0.938198
738,44,32472,240266777,256059356,0.938325
739,37,27343,240294120,256059356,0.938431
740,28,20720,240314840,256059356,0.938512
741,42,31122,240345962,256059356,0.938634
742,31,23002,240368964,256059356,0.938724
743,35,26005,240394969,256059356,0.938825
744,35,26040,240421009,256059356,0.938927
745,39,29055,240450064,256059356,0.93904
746,24,17904,240467968,256059356,0.93911
747,41,30627,240498595,256059356,0.93923
748,24,17952,240516547,256059356,0.9393
749,29,21721,240538268,256059356,0.939385
750,29,21750,240560018,256059356,0.93947
751,24,18024,240578042,256059356,0.93954
752,16,12032,240590074,256059356,0.939587
753,24,18072,240608146,256059356,0.939658
754,20,15080,240623226,256059356,0.939717
755,21,15855,240639081,256059356,0.939779
756,23,17388,240656469,256059356,0.939846
757,23,17411,240673880,256059356,0.939914
758,27,20466,240694346,256059356,0.939994
759,17,12903,240707249,256059356,0.940045
760,23,17480,240724729,256059356,0.940113
761,14,10654,240735383,256059356,0.940155
762,17,12954,240748337,256059356,0.940205
763,26,19838,240768175,256059356,0.940283
764,14,10696,240778871,256059356,0.940324
765,26,19890,240798761,256059356,0.940402
766,15,11490,240810251,256059356,0.940447
767,22,16874,240827125,256059356,0.940513
768,13,9984,240837109,256059356,0.940552
769,21,16149,240853258,256059356,0.940615
770,17,13090,240866348,256059356,0.940666
771,22,16962,240883310,256059356,0.940732
772,17,13124,240896434,256059356,0.940784
773,15,11595,240908029,256059356,0.940829
774,17,13158,240921187,256059356,0.94088
775,15,11625,240932812,256059356,0.940926
776,43,33368,240966180,256059356,0.941056
777,16,12432,240978612,256059356,0.941104
778,24,18672,240997284,256059356,0.941177
779,19,14801,241012085,256059356,0.941235
780,17,13260,241025345,256059356,0.941287
781,17,13277,241038622,256059356,0.941339
782,15,11730,241050352,256059356,0.941385
783,23,18009,241068361,256059356,0.941455
784,22,17248,241085609,256059356,0.941522
785,31,24335,241109944,256059356,0.941617
786,17,13362,241123306,256059356,0.94167
787,42,33054,241156360,256059356,0.941799
788,17,13396,241169756,256059356,0.941851
789,11,8679,241178435,256059356,0.941885
790,49,38710,241217145,256059356,0.942036
791,17,13447,241230592,256059356,0.942089
792,82,64944,241295536,256059356,0.942342
793,30,23790,241319326,256059356,0.942435
794,20,15880,241335206,256059356,0.942497
795,44,34980,241370186,256059356,0.942634
796,25,19900,241390086,256059356,0.942711
797,14,11158,241401244,256059356,0.942755
798,28,22344,241423588,256059356,0.942842
799,18,14382,241437970,256059356,0.942898
800,21,16800,241454770,256059356,0.942964
801,19,15219,241469989,256059356,0.943023
802,28,22456,241492445,256059356,0.943111
803,17,13651,241506096,256059356,0.943165
804,18,14472,241520568,256059356,0.943221
805,13,10465,241531033,256059356,0.943262
806,10,8060,241539093,256059356,0.943293
807,26,20982,241560075,256059356,0.943375
808,22,17776,241577851,256059356,0.943445
809,13,10517,241588368,256059356,0.943486
810,16,12960,241601328,256059356,0.943536
811,9,7299,241608627,256059356,0.943565
812,6,4872,241613499,256059356,0.943584
813,15,12195,241625694,256059356,0.943632
814,14,11396,241637090,256059356,0.943676
815,12,9780,241646870,256059356,0.943714
816,15,12240,241659110,256059356,0.943762
817,12,9804,241668914,256059356,0.9438
818,22,17996,241686910,256059356,0.943871
819,14,11466,241698376,256059356,0.943915
820,13,10660,241709036,256059356,0.943957
821,16,13136,241722172,256059356,0.944008
822,16,13152,241735324,256059356,0.94406
823,14,11522,241746846,256059356,0.944105
824,14,11536,241758382,256059356,0.94415
825,13,10725,241769107,256059356,0.944192
826,14,11564,241780671,256059356,0.944237
827,9,7443,241788114,256059356,0.944266
828,8,6624,241794738,256059356,0.944292
829,10,8290,241803028,256059356,0.944324
830,16,13280,241816308,256059356,0.944376
831,8,6648,241822956,256059356,0.944402
832,11,9152,241832108,256059356,0.944438
833,14,11662,241843770,256059356,0.944483
834,14,11676,241855446,256059356,0.944529
835,14,11690,241867136,256059356,0.944574
836,8,6688,241873824,256059356,0.944601
837,10,8370,241882194,256059356,0.944633
838,16,13408,241895602,256059356,0.944686
839,11,9229,241904831,256059356,0.944722
840,9,7560,241912391,256059356,0.944751
841,9,7569,241919960,256059356,0.944781
842,1301,1095442,243015402,256059356,0.949059
843,31,26133,243041535,256059356,0.949161
844,17,14348,243055883,256059356,0.949217
845,826,697970,243753853,256059356,0.951943
846,17,14382,243768235,256059356,0.951999
847,10,8470,243776705,256059356,0.952032
848,537,455376,244232081,256059356,0.95381
849,22,18678,244250759,256059356,0.953883
850,15,12750,244263509,256059356,0.953933
851,306,260406,244523915,256059356,0.95495
852,15,12780,244536695,256059356,0.955
853,10,8530,244545225,256059356,0.955033
854,174,148596,244693821,256059356,0.955614
855,13,11115,244704936,256059356,0.955657
856,9,7704,244712640,256059356,0.955687
857,99,84843,244797483,256059356,0.956019
858,8,6864,244804347,256059356,0.956045
859,12,10308,244814655,256059356,0.956086
860,53,45580,244860235,256059356,0.956264
861,10,8610,244868845,256059356,0.956297
862,11,9482,244878327,256059356,0.956334
863,35,30205,244908532,256059356,0.956452
864,10,8640,244917172,256059356,0.956486
865,9,7785,244924957,256059356,0.956516
866,160,138560,245063517,256059356,0.957057
867,8,6936,245070453,256059356,0.957085
868,8,6944,245077397,256059356,0.957112
869,85,73865,245151262,256059356,0.9574
870,8,6960,245158222,256059356,0.957427
871,9,7839,245166061,256059356,0.957458
872,39,34008,245200069,256059356,0.957591
873,4,3492,245203561,256059356,0.957604
874,13,11362,245214923,256059356,0.957649
875,31,27125,245242048,256059356,0.957755
876,10,8760,245250808,256059356,0.957789
877,10,8770,245259578,256059356,0.957823
878,21,18438,245278016,256059356,0.957895
879,6,5274,245283290,256059356,0.957916
880,5,4400,245287690,256059356,0.957933
881,16,14096,245301786,256059356,0.957988
882,7,6174,245307960,256059356,0.958012
883,12,10596,245318556,256059356,0.958053
884,12,10608,245329164,256059356,0.958095
885,12,10620,245339784,256059356,0.958136
886,6,5316,245345100,256059356,0.958157
887,15,13305,245358405,256059356,0.958209
888,4,3552,245361957,256059356,0.958223
889,12,10668,245372625,256059356,0.958265
890,9,8010,245380635,256059356,0.958296
891,6,5346,245385981,256059356,0.958317
892,6,5352,245391333,256059356,0.958338
893,15,13395,245404728,256059356,0.95839
894,2,1788,245406516,256059356,0.958397
895,6,5370,245411886,256059356,0.958418
896,6,5376,245417262,256059356,0.958439
897,14,12558,245429820,256059356,0.958488
898,8,7184,245437004,256059356,0.958516
899,8,7192,245444196,256059356,0.958544
900,5,4500,245448696,256059356,0.958562
901,3,2703,245451399,256059356,0.958572
902,4,3608,245455007,256059356,0.958586
903,3,2709,245457716,256059356,0.958597
904,8,7232,245464948,256059356,0.958625
905,8,7240,245472188,256059356,0.958653
906,10,9060,245481248,256059356,0.958689
907,3,2721,245483969,256059356,0.958699
908,5,4540,245488509,256059356,0.958717
909,6,5454,245493963,256059356,0.958739
910,7,6370,245500333,256059356,0.958763
911,7,6377,245506710,256059356,0.958788
912,6,5472,245512182,256059356,0.95881
913,5,4565,245516747,256059356,0.958827
914,4,3656,245520403,256059356,0.958842
915,6,5490,245525893,256059356,0.958863
916,4,3664,245529557,256059356,0.958878
917,4,3668,245533225,256059356,0.958892
918,5,4590,245537815,256059356,0.95891
919,1,919,245538734,256059356,0.958913
920,9,8280,245547014,256059356,0.958946
921,6,5526,245552540,256059356,0.958967
922,9,8298,245560838,256059356,0.959
923,3,2769,245563607,256059356,0.95901
924,8,7392,245570999,256059356,0.959039
925,9,8325,245579324,256059356,0.959072
926,5,4630,245583954,256059356,0.95909
927,6,5562,245589516,256059356,0.959112
928,4,3712,245593228,256059356,0.959126
929,2,1858,245595086,256059356,0.959133
930,6,5580,245600666,256059356,0.959155
931,2,1862,245602528,256059356,0.959162
932,6,5592,245608120,256059356,0.959184
933,5,4665,245612785,256059356,0.959203
934,8,7472,245620257,256059356,0.959232
935,6,5610,245625867,256059356,0.959254
936,4,3744,245629611,256059356,0.959268
937,8,7496,245637107,256059356,0.959298
938,2,1876,245638983,256059356,0.959305
939,1,939,245639922,256059356,0.959309
940,6,5640,245645562,256059356,0.959331
941,4,3764,245649326,256059356,0.959345
942,4,3768,245653094,256059356,0.95936
943,4,3772,245656866,256059356,0.959375
944,3,2832,245659698,256059356,0.959386
945,5,4725,245664423,256059356,0.959404
946,4,3784,245668207,256059356,0.959419
947,5,4735,245672942,256059356,0.959437
948,3,2844,245675786,256059356,0.959449
949,5,4745,245680531,256059356,0.959467
950,4,3800,245684331,256059356,0.959482
951,3,2853,245687184,256059356,0.959493
952,5,4760,245691944,256059356,0.959512
953,6,5718,245697662,256059356,0.959534
954,4,3816,245701478,256059356,0.959549
955,6,5730,245707208,256059356,0.959571
956,2,1912,245709120,256059356,0.959579
957,2,1914,245711034,256059356,0.959586
958,7,6706,245717740,256059356,0.959612
959,3,2877,245720617,256059356,0.959624
960,6,5760,245726377,256059356,0.959646
961,3,2883,245729260,256059356,0.959657
962,3,2886,245732146,256059356,0.959669
963,2,1926,245734072,256059356,0.959676
964,6,5784,245739856,256059356,0.959699
965,4,3860,245743716,256059356,0.959714
966,5,4830,245748546,256059356,0.959733
967,5,4835,245753381,256059356,0.959752
968,7,6776,245760157,256059356,0.959778
969,4,3876,245764033,256059356,0.959793
970,7,6790,245770823,256059356,0.95982
971,5,4855,245775678,256059356,0.959839
972,2,1944,245777622,256059356,0.959846
973,3,2919,245780541,256059356,0.959858
974,4,3896,245784437,256059356,0.959873
975,7,6825,245791262,256059356,0.9599
976,4,3904,245795166,256059356,0.959915
977,23,22471,245817637,256059356,0.960003
978,6,5868,245823505,256059356,0.960025
979,6,5874,245829379,256059356,0.960048
980,16,15680,245845059,256059356,0.96011
981,8,7848,245852907,256059356,0.96014
982,11,10802,245863709,256059356,0.960182
983,6,5898,245869607,256059356,0.960206
984,17,16728,245886335,256059356,0.960271
985,13,12805,245899140,256059356,0.960321
986,12,11832,245910972,256059356,0.960367
987,10,9870,245920842,256059356,0.960406
988,11,10868,245931710,256059356,0.960448
989,12,11868,245943578,256059356,0.960494
990,12,11880,245955458,256059356,0.960541
991,7,6937,245962395,256059356,0.960568
992,18,17856,245980251,256059356,0.960638
993,15,14895,245995146,256059356,0.960696
994,5,4970,246000116,256059356,0.960715
995,11,10945,246011061,256059356,0.960758
996,11,10956,246022017,256059356,0.960801
997,8,7976,246029993,256059356,0.960832
998,15,14970,246044963,256059356,0.96089
999,15,14985,246059948,256059356,0.960949
1000,13,13000,246072948,256059356,0.961
1001,9,9009,246081957,256059356,0.961035
1002,16,16032,246097989,256059356,0.961097
1003,10,10030,246108019,256059356,0.961137
1004,13,13052,246121071,256059356,0.961188
1005,10,10050,246131121,256059356,0.961227
1006,10,10060,246141181,256059356,0.961266
1007,9,9063,246150244,256059356,0.961302
1008,10,10080,246160324,256059356,0.961341
1009,12,12108,246172432,256059356,0.961388
1010,12,12120,246184552,256059356,0.961435
1011,7,7077,246191629,256059356,0.961463
1012,10,10120,246201749,256059356,0.961503
1013,10,10130,246211879,256059356,0.961542
1014,13,13182,246225061,256059356,0.961594
1015,11,11165,246236226,256059356,0.961637
1016,7,7112,246243338,256059356,0.961665
1017,6,6102,246249440,256059356,0.961689
1018,5,5090,246254530,256059356,0.961709
1019,6,6114,246260644,256059356,0.961733
1020,8,8160,246268804,256059356,0.961765
1021,12,12252,246281056,256059356,0.961812
1022,3,3066,246284122,256059356,0.961824
1023,5,5115,246289237,256059356,0.961844
1024,8,8192,246297429,256059356,0.961876
1025,10,10250,246307679,256059356,0.961916
1026,17,17442,246325121,256059356,0.961984
1027,8,8216,246333337,256059356,0.962017
1028,20,20560,246353897,256059356,0.962097
1029,14,14406,246368303,256059356,0.962153
1030,42,43260,246411563,256059356,0.962322
1031,26,26806,246438369,256059356,0.962427
1032,153,157896,246596265,256059356,0.963043
1033,73,75409,246671674,256059356,0.963338
1034,447,462198,247133872,256059356,0.965143
1035,82,84870,247218742,256059356,0.965474
1036,262,271432,247490174,256059356,0.966534
1037,133,137921,247628095,256059356,0.967073
1038,125,129750,247757845,256059356,0.96758
1039,149,154811,247912656,256059356,0.968184
1040,104,108160,248020816,256059356,0.968607
1041,122,127002,248147818,256059356,0.969103
1042,112,116704,248264522,256059356,0.969558
1043,111,115773,248380295,256059356,0.970011
1044,116,121104,248501399,256059356,0.970484
1045,86,89870,248591269,256059356,0.970835
1046,78,81588,248672857,256059356,0.971153
1047,97,101559,248774416,256059356,0.97155
1048,74,77552,248851968,256059356,0.971853
1049,72,75528,248927496,256059356,0.972148
1050,83,87150,249014646,256059356,0.972488
1051,51,53601,249068247,256059356,0.972697
1052,41,43132,249111379,256059356,0.972866
1053,67,70551,249181930,256059356,0.973141
1054,42,44268,249226198,256059356,0.973314
1055,56,59080,249285278,256059356,0.973545
1056,50,52800,249338078,256059356,0.973751
1057,43,45451,249383529,256059356,0.973929
1058,51,53958,249437487,256059356,0.974139
1059,41,43419,249480906,256059356,0.974309
1060,54,57240,249538146,256059356,0.974532
1061,39,41379,249579525,256059356,0.974694
1062,46,48852,249628377,256059356,0.974885
1063,40,42520,249670897,256059356,0.975051
1064,32,34048,249704945,256059356,0.975184
1065,38,40470,249745415,256059356,0.975342
1066,34,36244,249781659,256059356,0.975483
1067,28,29876,249811535,256059356,0.9756
1068,22,23496,249835031,256059356,0.975692
1069,25,26725,249861756,256059356,0.975796
1070,23,24610,249886366,256059356,0.975892
1071,23,24633,249910999,256059356,0.975989
1072,28,30016,249941015,256059356,0.976106
1073,12,12876,249953891,256059356,0.976156
1074,30,32220,249986111,256059356,0.976282
1075,19,20425,250006536,256059356,0.976362
1076,39,41964,250048500,256059356,0.976526
1077,17,18309,250066809,256059356,0.976597
1078,29,31262,250098071,256059356,0.976719
1079,22,23738,250121809,256059356,0.976812
1080,18,19440,250141249,256059356,0.976888
1081,25,27025,250168274,256059356,0.976993
1082,20,21640,250189914,256059356,0.977078
1083,23,24909,250214823,256059356,0.977175
1084,18,19512,250234335,256059356,0.977251
1085,11,11935,250246270,256059356,0.977298
1086,10,10860,250257130,256059356,0.97734
1087,12,13044,250270174,256059356,0.977391
1088,10,10880,250281054,256059356,0.977434
1089,16,17424,250298478,256059356,0.977502
1090,3,3270,250301748,256059356,0.977515
1091,11,12001,250313749,256059356,0.977561
1092,15,16380,250330129,256059356,0.977625
1093,9,9837,250339966,256059356,0.977664
1094,10,10940,250350906,256059356,0.977707
1095,8,8760,250359666,256059356,0.977741
1096,10,10960,250370626,256059356,0.977784
1097,8,8776,250379402,256059356,0.977818
1098,5,5490,250384892,256059356,0.977839
1099,9,9891,250394783,256059356,0.977878
1100,7,7700,250402483,256059356,0.977908
1101,5,5505,250407988,256059356,0.977929
1102,4,4408,250412396,256059356,0.977947
1103,10,11030,250423426,256059356,0.97799
1104,9,9936,250433362,256059356,0.978029
1105,5,5525,250438887,256059356,0.97805
1106,2,2212,250441099,256059356,0.978059
1107,4,4428,250445527,256059356,0.978076
1108,4,4432,250449959,256059356,0.978093
1109,6,6654,250456613,256059356,0.978119
1110,4,4440,250461053,256059356,0.978137
1111,3,3333,250464386,256059356,0.97815
1112,6,6672,250471058,256059356,0.978176
1113,2,2226,250473284,256059356,0.978184
1114,9,10026,250483310,256059356,0.978224
1115,8,8920,250492230,256059356,0.978258
1116,5,5580,250497810,256059356,0.97828
1117,1,1117,250498927,256059356,0.978285
1118,3,3354,250502281,256059356,0.978298
1119,4,4476,250506757,256059356,0.978315
1120,3,3360,250510117,256059356,0.978328
1121,5,5605,250515722,256059356,0.97835
1122,3,3366,250519088,256059356,0.978363
1123,3,3369,250522457,256059356,0.978377
1124,3,3372,250525829,256059356,0.97839
1125,3,3375,250529204,256059356,0.978403
1126,2,2252,250531456,256059356,0.978412
1127,2,2254,250533710,256059356,0.97842
1128,6,6768,250540478,256059356,0.978447
1129,1,1129,250541607,256059356,0.978451
1130,1,1130,250542737,256059356,0.978456
1131,2,2262,250544999,256059356,0.978465
1132,4,4528,250549527,256059356,0.978482
1133,7,7931,250557458,256059356,0.978513
1134,5,5670,250563128,256059356,0.978535
1135,6,6810,250569938,256059356,0.978562
1136,4,4544,250574482,256059356,0.97858
1137,2,2274,250576756,256059356,0.978589
1139,3,3417,250580173,256059356,0.978602
1140,4,4560,250584733,256059356,0.97862
1141,8,9128,250593861,256059356,0.978655
1142,2,2284,250596145,256059356,0.978664
1143,2,2286,250598431,256059356,0.978673
1144,2,2288,250600719,256059356,0.978682
1145,5,5725,250606444,256059356,0.978705
1146,2,2292,250608736,256059356,0.978713
1147,5,5735,250614471,256059356,0.978736
1148,4,4592,250619063,256059356,0.978754
1149,5,5745,250624808,256059356,0.978776
1150,5,5750,250630558,256059356,0.978799
1151,4,4604,250635162,256059356,0.978817
1152,3,3456,250638618,256059356,0.97883
1153,4,4612,250643230,256059356,0.978848
1154,4,4616,250647846,256059356,0.978866
1156,2,2312,250650158,256059356,0.978875
1157,3,3471,250653629,256059356,0.978889
1158,2,2316,250655945,256059356,0.978898
1159,4,4636,250660581,256059356,0.978916
1160,2,2320,250662901,256059356,0.978925
1161,2,2322,250665223,256059356,0.978934
1162,2,2324,250667547,256059356,0.978943
1163,7,8141,250675688,256059356,0.978975
1164,1,1164,250676852,256059356,0.978979
1165,3,3495,250680347,256059356,0.978993
1166,2,2332,250682679,256059356,0.979002
1169,3,3507,250686186,256059356,0.979016
1170,2,2340,250688526,256059356,0.979025
1171,5,5855,250694381,256059356,0.979048
1172,5,5860,250700241,256059356,0.979071
1173,1,1173,250701414,256059356,0.979075
1174,7,8218,250709632,256059356,0.979107
1175,1,1175,250710807,256059356,0.979112
1176,4,4704,250715511,256059356,0.97913
1177,4,4708,250720219,256059356,0.979149
1179,2,2358,250722577,256059356,0.979158
1180,3,3540,250726117,256059356,0.979172
1181,6,7086,250733203,256059356,0.9792
1182,5,5910,250739113,256059356,0.979223
1183,2,2366,250741479,256059356,0.979232
1184,2,2368,250743847,256059356,0.979241
1186,1,1186,250745033,256059356,0.979246
1187,5,5935,250750968,256059356,0.979269
1189,3,3567,250754535,256059356,0.979283
1190,3,3570,250758105,256059356,0.979297
1191,4,4764,250762869,256059356,0.979315
1192,4,4768,250767637,256059356,0.979334
1193,2,2386,250770023,256059356,0.979343
1194,5,5970,250775993,256059356,0.979367
1195,4,4780,250780773,256059356,0.979385
1196,1,1196,250781969,256059356,0.97939
1197,2,2394,250784363,256059356,0.979399
1198,2,2396,250786759,256059356,0.979409
1201,3,3603,250790362,256059356,0.979423
1202,2,2404,250792766,256059356,0.979432
1204,3,3612,250796378,256059356,0.979446
1205,1,1205,250797583,256059356,0.979451
1206,4,4824,250802407,256059356,0.97947
1207,4,4828,250807235,256059356,0.979489
1208,2,2416,250809651,256059356,0.979498
1209,1,1209,250810860,256059356,0.979503
1210,1,1210,250812070,256059356,0.979508
1211,3,3633,250815703,256059356,0.979522
1212,2,2424,250818127,256059356,0.979531
1213,1,1213,250819340,256059356,0.979536
1214,5,6070,250825410,256059356,0.97956
1215,1,1215,250826625,256059356,0.979564
1216,2,2432,250829057,256059356,0.979574
1217,2,2434,250831491,256059356,0.979583
1218,1,1218,250832709,256059356,0.979588
1219,5,6095,250838804,256059356,0.979612
1221,3,3663,250842467,256059356,0.979626
1223,1,1223,250843690,256059356,0.979631
1224,2,2448,250846138,256059356,0.979641
1225,1,1225,250847363,256059356,0.979645
1226,1,1226,250848589,256059356,0.97965
1228,1,1228,250849817,256059356,0.979655
1229,1,1229,250851046,256059356,0.97966
1230,4,4920,250855966,256059356,0.979679
1231,1,1231,250857197,256059356,0.979684
1233,1,1233,250858430,256059356,0.979689
1234,2,2468,250860898,256059356,0.979698
1235,1,1235,250862133,256059356,0.979703
1236,1,1236,250863369,256059356,0.979708
1237,1,1237,250864606,256059356,0.979713
1238,4,4952,250869558,256059356,0.979732
1239,3,3717,250873275,256059356,0.979747
1240,2,2480,250875755,256059356,0.979756
1241,3,3723,250879478,256059356,0.979771
1242,7,8694,250888172,256059356,0.979805
1243,3,3729,250891901,256059356,0.979819
1245,5,6225,250898126,256059356,0.979844
1247,2,2494,250900620,256059356,0.979853
1250,1,1250,250901870,256059356,0.979858
1251,5,6255,250908125,256059356,0.979883
1252,4,5008,250913133,256059356,0.979902
1253,1,1253,250914386,256059356,0.979907
1255,2,2510,250916896,256059356,0.979917
1256,1,1256,250918152,256059356,0.979922
1257,1,1257,250919409,256059356,0.979927
1258,5,6290,250925699,256059356,0.979951
1259,2,2518,250928217,256059356,0.979961
1260,4,5040,250933257,256059356,0.979981
1261,4,5044,250938301,256059356,0.980001
1262,4,5048,250943349,256059356,0.98002
1263,1,1263,250944612,256059356,0.980025
1265,1,1265,250945877,256059356,0.98003
1266,4,5064,250950941,256059356,0.98005
1268,4,5072,250956013,256059356,0.98007
1270,2,2540,250958553,256059356,0.98008
1271,1,1271,250959824,256059356,0.980085
1272,4,5088,250964912,256059356,0.980104
1273,2,2546,250967458,256059356,0.980114
1274,2,2548,250970006,256059356,0.980124
1275,2,2550,250972556,256059356,0.980134
1276,3,3828,250976384,256059356,0.980149
1278,2,2556,250978940,256059356,0.980159
1279,3,3837,250982777,256059356,0.980174
1280,2,2560,250985337,256059356,0.980184
1281,2,2562,250987899,256059356,0.980194
1282,1,1282,250989181,256059356,0.980199
1283,2,2566,250991747,256059356,0.980209
1284,2,2568,250994315,256059356,0.980219
1285,2,2570,250996885,256059356,0.980229
1286,1,1286,250998171,256059356,0.980234
1287,1,1287,250999458,256059356,0.980239
1288,2,2576,251002034,256059356,0.980249
1289,2,2578,251004612,256059356,0.980259
1290,1,1290,251005902,256059356,0.980265
1292,2,2584,251008486,256059356,0.980275
1293,1,1293,251009779,256059356,0.98028
1294,1,1294,251011073,256059356,0.980285
1296,1,1296,251012369,256059356,0.98029
1297,2,2594,251014963,256059356,0.9803
1300,1,1300,251016263,256059356,0.980305
1301,1,1301,251017564,256059356,0.98031
1302,2,2604,251020168,256059356,0.98032
1306,2,2612,251022780,256059356,0.98033
1307,2,2614,251025394,256059356,0.980341
1308,3,3924,251029318,256059356,0.980356
1309,1,1309,251030627,256059356,0.980361
1310,1,1310,251031937,256059356,0.980366
1311,1,1311,251033248,256059356,0.980371
1312,1,1312,251034560,256059356,0.980376
1313,1,1313,251035873,256059356,0.980382
1315,1,1315,251037188,256059356,0.980387
1316,3,3948,251041136,256059356,0.980402
1320,2,2640,251043776,256059356,0.980412
1321,1,1321,251045097,256059356,0.980418
1323,1,1323,251046420,256059356,0.980423
1324,1,1324,251047744,256059356,0.980428
1327,1,1327,251049071,256059356,0.980433
1328,1,1328,251050399,256059356,0.980438
1329,1,1329,251051728,256059356,0.980443
1330,2,2660,251054388,256059356,0.980454
1331,2,2662,251057050,256059356,0.980464
1332,4,5328,251062378,256059356,0.980485
1333,3,3999,251066377,256059356,0.980501
1334,3,4002,251070379,256059356,0.980516
1335,2,2670,251073049,256059356,0.980527
1337,3,4011,251077060,256059356,0.980542
1339,2,2678,251079738,256059356,0.980553
1342,3,4026,251083764,256059356,0.980569
1344,1,1344,251085108,256059356,0.980574
1345,1,1345,251086453,256059356,0.980579
1346,1,1346,251087799,256059356,0.980584
1348,1,1348,251089147,256059356,0.98059
1349,1,1349,251090496,256059356,0.980595
1350,1,1350,251091846,256059356,0.9806
1352,2,2704,251094550,256059356,0.980611
1354,1,1354,251095904,256059356,0.980616
1355,3,4065,251099969,256059356,0.980632
1360,2,2720,251102689,256059356,0.980643
1361,2,2722,251105411,256059356,0.980653
1363,3,4089,251109500,256059356,0.980669
1364,1,1364,251110864,256059356,0.980674
1365,1,1365,251112229,256059356,0.98068
1366,1,1366,251113595,256059356,0.980685
1367,5,6835,251120430,256059356,0.980712
1368,1,1368,251121798,256059356,0.980717
1370,1,1370,251123168,256059356,0.980722
1371,1,1371,251124539,256059356,0.980728
1372,1,1372,251125911,256059356,0.980733
1373,5,6865,251132776,256059356,0.98076
1374,2,2748,251135524,256059356,0.980771
1375,4,5500,251141024,256059356,0.980792
1376,3,4128,251145152,256059356,0.980808
1377,3,4131,251149283,256059356,0.980824
1378,1,1378,251150661,256059356,0.98083
1379,1,1379,251152040,256059356,0.980835
1380,1,1380,251153420,256059356,0.980841
1381,1,1381,251154801,256059356,0.980846
1382,1,1382,251156183,256059356,0.980851
1384,1,1384,251157567,256059356,0.980857
1385,4,5540,251163107,256059356,0.980878
1386,2,2772,251165879,256059356,0.980889
1389,2,2778,251168657,256059356,0.9809
1391,2,2782,251171439,256059356,0.980911
1392,2,2784,251174223,256059356,0.980922
1393,1,1393,251175616,256059356,0.980927
1397,1,1397,251177013,256059356,0.980933
1398,2,2796,251179809,256059356,0.980944
1399,3,4197,251184006,256059356,0.98096
1400,1,1400,251185406,256059356,0.980966
1401,1,1401,251186807,256059356,0.980971
1402,1,1402,251188209,256059356,0.980976
1403,1,1403,251189612,256059356,0.980982
1404,3,4212,251193824,256059356,0.980998
1407,4,5628,251199452,256059356,0.98102
1408,1,1408,251200860,256059356,0.981026
1409,3,4227,251205087,256059356,0.981042
1412,3,4236,251209323,256059356,0.981059
1413,1,1413,251210736,256059356,0.981064
1416,1,1416,251212152,256059356,0.98107
1418,1,1418,251213570,256059356,0.981076
1420,1,1420,251214990,256059356,0.981081
1421,1,1421,251216411,256059356,0.981087
1423,3,4269,251220680,256059356,0.981103
1424,1,1424,251222104,256059356,0.981109
1425,1,1425,251223529,256059356,0.981114
1428,1,1428,251224957,256059356,0.98112
1430,1,1430,251226387,256059356,0.981126
1434,5,7170,251233557,256059356,0.981154
1436,1,1436,251234993,256059356,0.981159
1438,2,2876,251237869,256059356,0.98117
1439,2,2878,251240747,256059356,0.981182
1440,1,1440,251242187,256059356,0.981187
1442,3,4326,251246513,256059356,0.981204
1443,1,1443,251247956,256059356,0.98121
1444,2,2888,251250844,256059356,0.981221
1445,3,4335,251255179,256059356,0.981238
1446,2,2892,251258071,256059356,0.981249
1448,1,1448,251259519,256059356,0.981255
1450,1,1450,251260969,256059356,0.981261
1451,1,1451,251262420,256059356,0.981266
1452,1,1452,251263872,256059356,0.981272
1454,2,2908,251266780,256059356,0.981283
1458,1,1458,251268238,256059356,0.981289
1460,1,1460,251269698,256059356,0.981295
1461,1,1461,251271159,256059356,0.9813
1462,2,2924,251274083,256059356,0.981312
1463,1,1463,251275546,256059356,0.981318
1464,1,1464,251277010,256059356,0.981323
1465,1,1465,251278475,256059356,0.981329
1468,1,1468,251279943,256059356,0.981335
1471,2,2942,251282885,256059356,0.981346
1472,1,1472,251284357,256059356,0.981352
1474,1,1474,251285831,256059356,0.981358
1475,1,1475,251287306,256059356,0.981364
1476,2,2952,251290258,256059356,0.981375
1477,1,1477,251291735,256059356,0.981381
1481,1,1481,251293216,256059356,0.981387
1482,3,4446,251297662,256059356,0.981404
1484,3,4452,251302114,256059356,0.981421
1487,3,4461,251306575,256059356,0.981439
1488,1,1488,251308063,256059356,0.981445
1489,2,2978,251311041,256059356,0.981456
1492,1,1492,251312533,256059356,0.981462
1493,1,1493,251314026,256059356,0.981468
1494,2,2988,251317014,256059356,0.98148
1495,1,1495,251318509,256059356,0.981485
1496,1,1496,251320005,256059356,0.981491
1497,1,1497,251321502,256059356,0.981497
1498,1,1498,251323000,256059356,0.981503
1499,1,1499,251324499,256059356,0.981509
1500,1,1500,251325999,256059356,0.981515
1501,2,3002,251329001,256059356,0.981526
1504,2,3008,251332009,256059356,0.981538
1508,1,1508,251333517,256059356,0.981544
1509,1,1509,251335026,256059356,0.98155
1510,3,4530,251339556,256059356,0.981568
1511,1,1511,251341067,256059356,0.981573
1512,2,3024,251344091,256059356,0.981585
1514,1,1514,251345605,256059356,0.981591
1516,1,1516,251347121,256059356,0.981597
1517,2,3034,251350155,256059356,0.981609
1521,2,3042,251353197,256059356,0.981621
1522,1,1522,251354719,256059356,0.981627
1525,1,1525,251356244,256059356,0.981633
1526,1,1526,251357770,256059356,0.981639
1531,2,3062,251360832,256059356,0.981651
1534,3,4602,251365434,256059356,0.981669
1536,1,1536,251366970,256059356,0.981675
1537,1,1537,251368507,256059356,0.981681
1538,1,1538,251370045,256059356,0.981687
1539,1,1539,251371584,256059356,0.981693
1541,2,3082,251374666,256059356,0.981705
1543,1,1543,251376209,256059356,0.981711
1546,2,3092,251379301,256059356,0.981723
1547,2,3094,251382395,256059356,0.981735
1551,1,1551,251383946,256059356,0.981741
1555,2,3110,251387056,256059356,0.981753
1556,1,1556,251388612,256059356,0.981759
1558,1,1558,251390170,256059356,0.981765
1559,1,1559,251391729,256059356,0.981771
1561,1,1561,251393290,256059356,0.981777
1562,2,3124,251396414,256059356,0.98179
1563,1,1563,251397977,256059356,0.981796
1564,2,3128,251401105,256059356,0.981808
1565,2,3130,251404235,256059356,0.98182
1569,2,3138,251407373,256059356,0.981832
1570,1,1570,251408943,256059356,0.981839
1572,1,1572,251410515,256059356,0.981845
1574,3,4722,251415237,256059356,0.981863
1575,1,1575,251416812,256059356,0.981869
1576,1,1576,251418388,256059356,0.981875
1577,1,1577,251419965,256059356,0.981882
1578,1,1578,251421543,256059356,0.981888
1580,1,1580,251423123,256059356,0.981894
1581,1,1581,251424704,256059356,0.9819
1582,1,1582,251426286,256059356,0.981906
1588,1,1588,251427874,256059356,0.981912
1590,1,1590,251429464,256059356,0.981919
1596,1,1596,251431060,256059356,0.981925
1597,1,1597,251432657,256059356,0.981931
1598,2,3196,251435853,256059356,0.981944
1600,1,1600,251437453,256059356,0.98195
1601,1,1601,251439054,256059356,0.981956
1603,1,1603,251440657,256059356,0.981962
1610,1,1610,251442267,256059356,0.981969
1611,1,1611,251443878,256059356,0.981975
1612,2,3224,251447102,256059356,0.981988
1614,1,1614,251448716,256059356,0.981994
1616,1,1616,251450332,256059356,0.982
1621,1,1621,251451953,256059356,0.982007
1623,2,3246,251455199,256059356,0.982019
1624,1,1624,251456823,256059356,0.982026
1625,1,1625,251458448,256059356,0.982032
1626,2,3252,251461700,256059356,0.982045
1627,1,1627,251463327,256059356,0.982051
1628,1,1628,251464955,256059356,0.982057
1629,1,1629,251466584,256059356,0.982064
1630,1,1630,251468214,256059356,0.98207
1632,1,1632,251469846,256059356,0.982076
1634,1,1634,251471480,256059356,0.982083
1637,1,1637,251473117,256059356,0.982089
1638,1,1638,251474755,256059356,0.982096
1640,2,3280,251478035,256059356,0.982108
1642,1,1642,251479677,256059356,0.982115
1649,1,1649,251481326,256059356,0.982121
1651,1,1651,251482977,256059356,0.982128
1652,2,3304,251486281,256059356,0.982141
1654,1,1654,251487935,256059356,0.982147
1655,2,3310,251491245,256059356,0.98216
1659,1,1659,251492904,256059356,0.982166
1660,1,1660,251494564,256059356,0.982173
1663,2,3326,251497890,256059356,0.982186
1666,1,1666,251499556,256059356,0.982192
1671,1,1671,251501227,256059356,0.982199
1675,1,1675,251502902,256059356,0.982205
1676,1,1676,251504578,256059356,0.982212
1680,1,1680,251506258,256059356,0.982219
1684,1,1684,251507942,256059356,0.982225
1689,2,3378,251511320,256059356,0.982238
1691,1,1691,251513011,256059356,0.982245
1692,1,1692,251514703,256059356,0.982252
1694,1,1694,251516397,256059356,0.982258
1699,1,1699,251518096,256059356,0.982265
1700,1,1700,251519796,256059356,0.982271
1702,1,1702,251521498,256059356,0.982278
1703,2,3406,251524904,256059356,0.982291
1706,1,1706,251526610,256059356,0.982298
1710,1,1710,251528320,256059356,0.982305
1711,2,3422,251531742,256059356,0.982318
1712,1,1712,251533454,256059356,0.982325
1720,1,1720,251535174,256059356,0.982332
1721,1,1721,251536895,256059356,0.982338
1723,1,1723,251538618,256059356,0.982345
1726,1,1726,251540344,256059356,0.982352
1727,1,1727,251542071,256059356,0.982358
1729,1,1729,251543800,256059356,0.982365
1742,1,1742,251545542,256059356,0.982372
1746,1,1746,251547288,256059356,0.982379
1747,2,3494,251550782,256059356,0.982392
1749,1,1749,251552531,256059356,0.982399
1751,2,3502,251556033,256059356,0.982413
1753,2,3506,251559539,256059356,0.982427
1754,1,1754,251561293,256059356,0.982434
1756,2,3512,251564805,256059356,0.982447
1758,2,3516,251568321,256059356,0.982461
1759,2,3518,251571839,256059356,0.982475
1760,1,1760,251573599,256059356,0.982482
1766,1,1766,251575365,256059356,0.982488
1769,1,1769,251577134,256059356,0.982495
1770,1,1770,251578904,256059356,0.982502
1775,1,1775,251580679,256059356,0.982509
1784,1,1784,251582463,256059356,0.982516
1785,1,1785,251584248,256059356,0.982523
1787,1,1787,251586035,256059356,0.98253
1788,1,1788,251587823,256059356,0.982537
1791,1,1791,251589614,256059356,0.982544
1796,1,1796,251591410,256059356,0.982551
1799,1,1799,251593209,256059356,0.982558
1802,1,1802,251595011,256059356,0.982565
1803,2,3606,251598617,256059356,0.982579
1806,1,1806,251600423,256059356,0.982586
1812,1,1812,251602235,256059356,0.982593
1813,2,3626,251605861,256059356,0.982608
1825,1,1825,251607686,256059356,0.982615
1828,1,1828,251609514,256059356,0.982622
1831,1,1831,251611345,256059356,0.982629
1835,1,1835,251613180,256059356,0.982636
1836,1,1836,251615016,256059356,0.982643
1853,1,1853,251616869,256059356,0.982651
1861,1,1861,251618730,256059356,0.982658
1870,1,1870,251620600,256059356,0.982665
1875,1,1875,251622475,256059356,0.982672
1878,2,3756,251626231,256059356,0.982687
1880,1,1880,251628111,256059356,0.982694
1887,1,1887,251629998,256059356,0.982702
1888,1,1888,251631886,256059356,0.982709
1889,1,1889,251633775,256059356,0.982717
1890,1,1890,251635665,256059356,0.982724
1895,1,1895,251637560,256059356,0.982731
1906,1,1906,251639466,256059356,0.982739
1913,2,3826,251643292,256059356,0.982754
1917,2,3834,251647126,256059356,0.982769
1923,1,1923,251649049,256059356,0.982776
1928,1,1928,251650977,256059356,0.982784
1929,1,1929,251652906,256059356,0.982791
1939,1,1939,251654845,256059356,0.982799
1943,1,1943,251656788,256059356,0.982806
1945,1,1945,251658733,256059356,0.982814
1948,1,1948,251660681,256059356,0.982822
1949,1,1949,251662630,256059356,0.982829
1954,1,1954,251664584,256059356,0.982837
1958,2,3916,251668500,256059356,0.982852
1959,1,1959,251670459,256059356,0.98286
1961,1,1961,251672420,256059356,0.982868
1965,1,1965,251674385,256059356,0.982875
1974,1,1974,251676359,256059356,0.982883
1977,1,1977,251678336,256059356,0.982891
1978,1,1978,251680314,256059356,0.982898
1984,1,1984,251682298,256059356,0.982906
1992,1,1992,251684290,256059356,0.982914
1998,2,3996,251688286,256059356,0.982929
1999,1,1999,251690285,256059356,0.982937
2014,1,2014,251692299,256059356,0.982945
2015,1,2015,251694314,256059356,0.982953
2017,1,2017,251696331,256059356,0.982961
2023,1,2023,251698354,256059356,0.982969
2024,1,2024,251700378,256059356,0.982977
2026,1,2026,251702404,256059356,0.982985
2038,2,4076,251706480,256059356,0.983001
2043,1,2043,251708523,256059356,0.983008
2044,1,2044,251710567,256059356,0.983016
2049,1,2049,251712616,256059356,0.983024
2058,1,2058,251714674,256059356,0.983033
2065,1,2065,251716739,256059356,0.983041
2066,1,2066,251718805,256059356,0.983049
2072,1,2072,251720877,256059356,0.983057
2075,1,2075,251722952,256059356,0.983065
2076,2,4152,251727104,256059356,0.983081
2078,1,2078,251729182,256059356,0.983089
2079,1,2079,251731261,256059356,0.983097
2092,1,2092,251733353,256059356,0.983105
2095,1,2095,251735448,256059356,0.983114
2097,1,2097,251737545,256059356,0.983122
2099,1,2099,251739644,256059356,0.98313
2107,1,2107,251741751,256059356,0.983138
2115,1,2115,251743866,256059356,0.983147
2122,1,2122,251745988,256059356,0.983155
2129,1,2129,251748117,256059356,0.983163
2131,1,2131,251750248,256059356,0.983171
2133,1,2133,251752381,256059356,0.98318
2140,1,2140,251754521,256059356,0.983188
2141,1,2141,251756662,256059356,0.983196
2142,1,2142,251758804,256059356,0.983205
2146,1,2146,251760950,256059356,0.983213
2147,1,2147,251763097,256059356,0.983222
2148,1,2148,251765245,256059356,0.98323
2154,1,2154,251767399,256059356,0.983238
2155,1,2155,251769554,256059356,0.983247
2157,1,2157,251771711,256059356,0.983255
2171,1,2171,251773882,256059356,0.983264
2178,1,2178,251776060,256059356,0.983272
2183,1,2183,251778243,256059356,0.983281
2189,1,2189,251780432,256059356,0.983289
2194,1,2194,251782626,256059356,0.983298
2195,1,2195,251784821,256059356,0.983306
2200,1,2200,251787021,256059356,0.983315
2201,1,2201,251789222,256059356,0.983324
2203,1,2203,251791425,256059356,0.983332
2211,1,2211,251793636,256059356,0.983341
2212,1,2212,251795848,256059356,0.98335
2216,1,2216,251798064,256059356,0.983358
2218,1,2218,251800282,256059356,0.983367
2226,1,2226,251802508,256059356,0.983376
2228,1,2228,251804736,256059356,0.983384
2241,1,2241,251806977,256059356,0.983393
2248,1,2248,251809225,256059356,0.983402
2250,1,2250,251811475,256059356,0.983411
2253,1,2253,251813728,256059356,0.983419
2258,1,2258,251815986,256059356,0.983428
2268,1,2268,251818254,256059356,0.983437
2277,1,2277,251820531,256059356,0.983446
2312,1,2312,251822843,256059356,0.983455
2317,1,2317,251825160,256059356,0.983464
2342,1,2342,251827502,256059356,0.983473
2353,1,2353,251829855,256059356,0.983482
2359,1,2359,251832214,256059356,0.983492
2363,1,2363,251834577,256059356,0.983501
2388,2,4776,251839353,256059356,0.983519
2412,1,2412,251841765,256059356,0.983529
2413,1,2413,251844178,256059356,0.983538
2420,1,2420,251846598,256059356,0.983548
2429,1,2429,251849027,256059356,0.983557
2430,1,2430,251851457,256059356,0.983567
2457,1,2457,251853914,256059356,0.983576
2463,1,2463,251856377,256059356,0.983586
2471,1,2471,251858848,256059356,0.983596
2496,1,2496,251861344,256059356,0.983605
2497,1,2497,251863841,256059356,0.983615
2501,1,2501,251866342,256059356,0.983625
2505,1,2505,251868847,256059356,0.983635
2508,2,5016,251873863,256059356,0.983654
2513,1,2513,251876376,256059356,0.983664
2520,1,2520,251878896,256059356,0.983674
2546,1,2546,251881442,256059356,0.983684
2547,1,2547,251883989,256059356,0.983694
2574,1,2574,251886563,256059356,0.983704
2582,1,2582,251889145,256059356,0.983714
2640,1,2640,251891785,256059356,0.983724
2641,1,2641,251894426,256059356,0.983735
2671,1,2671,251897097,256059356,0.983745
2689,1,2689,251899786,256059356,0.983755
2691,1,2691,251902477,256059356,0.983766
2693,1,2693,251905170,256059356,0.983776
2698,1,2698,251907868,256059356,0.983787
2710,1,2710,251910578,256059356,0.983798
2715,1,2715,251913293,256059356,0.983808
2725,1,2725,251916018,256059356,0.983819
2726,1,2726,251918744,256059356,0.983829
2747,1,2747,251921491,256059356,0.98384
2748,1,2748,251924239,256059356,0.983851
2768,1,2768,251927007,256059356,0.983862
2811,1,2811,251929818,256059356,0.983873
2840,1,2840,251932658,256059356,0.983884
2868,1,2868,251935526,256059356,0.983895
2895,1,2895,251938421,256059356,0.983906
2902,1,2902,251941323,256059356,0.983918
2905,1,2905,251944228,256059356,0.983929
2924,1,2924,251947152,256059356,0.98394
2953,1,2953,251950105,256059356,0.983952
2954,1,2954,251953059,256059356,0.983963
2968,1,2968,251956027,256059356,0.983975
2979,1,2979,251959006,256059356,0.983987
2987,1,2987,251961993,256059356,0.983998
2988,1,2988,251964981,256059356,0.98401
2994,1,2994,251967975,256059356,0.984022
3004,1,3004,251970979,256059356,0.984033
3008,1,3008,251973987,256059356,0.984045
3010,1,3010,251976997,256059356,0.984057
3052,1,3052,251980049,256059356,0.984069
3077,1,3077,251983126,256059356,0.984081
3092,1,3092,251986218,256059356,0.984093
3096,1,3096,251989314,256059356,0.984105
3098,1,3098,251992412,256059356,0.984117
3107,2,6214,251998626,256059356,0.984141
3123,1,3123,252001749,256059356,0.984154
3137,1,3137,252004886,256059356,0.984166
3142,1,3142,252008028,256059356,0.984178
3147,1,3147,252011175,256059356,0.98419
3148,1,3148,252014323,256059356,0.984203
3152,1,3152,252017475,256059356,0.984215
3167,1,3167,252020642,256059356,0.984227
3172,1,3172,252023814,256059356,0.98424
3189,2,6378,252030192,256059356,0.984265
3192,1,3192,252033384,256059356,0.984277
3201,1,3201,252036585,256059356,0.98429
3245,1,3245,252039830,256059356,0.984302
3252,1,3252,252043082,256059356,0.984315
3316,1,3316,252046398,256059356,0.984328
3319,1,3319,252049717,256059356,0.984341
3328,1,3328,252053045,256059356,0.984354
3337,1,3337,252056382,256059356,0.984367
3343,1,3343,252059725,256059356,0.98438
3363,1,3363,252063088,256059356,0.984393
3374,1,3374,252066462,256059356,0.984406
3382,1,3382,252069844,256059356,0.98442
3433,1,3433,252073277,256059356,0.984433
3444,1,3444,252076721,256059356,0.984446
3548,1,3548,252080269,256059356,0.98446
3586,1,3586,252083855,256059356,0.984474
3599,1,3599,252087454,256059356,0.984488
3600,1,3600,252091054,256059356,0.984502
3622,1,3622,252094676,256059356,0.984517
3674,1,3674,252098350,256059356,0.984531
3701,1,3701,252102051,256059356,0.984545
3729,1,3729,252105780,256059356,0.98456
3734,1,3734,252109514,256059356,0.984575
3761,1,3761,252113275,256059356,0.984589
3826,1,3826,252117101,256059356,0.984604
3838,1,3838,252120939,256059356,0.984619
3844,1,3844,252124783,256059356,0.984634
3850,1,3850,252128633,256059356,0.984649
3885,1,3885,252132518,256059356,0.984664
3895,1,3895,252136413,256059356,0.98468
3903,1,3903,252140316,256059356,0.984695
3918,1,3918,252144234,256059356,0.98471
3929,1,3929,252148163,256059356,0.984725
3973,1,3973,252152136,256059356,0.984741
3983,1,3983,252156119,256059356,0.984757
3985,1,3985,252160104,256059356,0.984772
4003,1,4003,252164107,256059356,0.984788
4007,1,4007,252168114,256059356,0.984803
4009,1,4009,252172123,256059356,0.984819
4027,1,4027,252176150,256059356,0.984835
4074,1,4074,252180224,256059356,0.984851
4078,1,4078,252184302,256059356,0.984867
4098,1,4098,252188400,256059356,0.984883
4115,1,4115,252192515,256059356,0.984899
4129,1,4129,252196644,256059356,0.984915
4135,1,4135,252200779,256059356,0.984931
4146,2,8292,252209071,256059356,0.984963
4174,1,4174,252213245,256059356,0.98498
4202,1,4202,252217447,256059356,0.984996
4220,1,4220,252221667,256059356,0.985013
4284,1,4284,252225951,256059356,0.985029
4297,1,4297,252230248,256059356,0.985046
4300,1,4300,252234548,256059356,0.985063
4432,1,4432,252238980,256059356,0.98508
4438,1,4438,252243418,256059356,0.985097
4450,1,4450,252247868,256059356,0.985115
4466,1,4466,252252334,256059356,0.985132
4513,1,4513,252256847,256059356,0.98515
4575,1,4575,252261422,256059356,0.985168
4625,1,4625,252266047,256059356,0.985186
4657,1,4657,252270704,256059356,0.985204
4686,1,4686,252275390,256059356,0.985222
4691,1,4691,252280081,256059356,0.985241
4699,1,4699,252284780,256059356,0.985259
4713,1,4713,252289493,256059356,0.985277
4721,1,4721,252294214,256059356,0.985296
4723,1,4723,252298937,256059356,0.985314
4736,1,4736,252303673,256059356,0.985333
4817,1,4817,252308490,256059356,0.985352
4893,1,4893,252313383,256059356,0.985371
4903,1,4903,252318286,256059356,0.98539
4910,1,4910,252323196,256059356,0.985409
4952,1,4952,252328148,256059356,0.985428
4958,1,4958,252333106,256059356,0.985448
4974,1,4974,252338080,256059356,0.985467
5078,1,5078,252343158,256059356,0.985487
5104,1,5104,252348262,256059356,0.985507
5122,1,5122,252353384,256059356,0.985527
5170,1,5170,252358554,256059356,0.985547
5336,1,5336,252363890,256059356,0.985568
5338,1,5338,252369228,256059356,0.985589
5369,1,5369,252374597,256059356,0.98561
5451,1,5451,252380048,256059356,0.985631
5602,1,5602,252385650,256059356,0.985653
5720,1,5720,252391370,256059356,0.985675
5756,1,5756,252397126,256059356,0.985698
5820,1,5820,252402946,256059356,0.98572
5867,1,5867,252408813,256059356,0.985743
6107,1,6107,252414920,256059356,0.985767
6209,1,6209,252421129,256059356,0.985791
6213,1,6213,252427342,256059356,0.985816
6221,1,6221,252433563,256059356,0.98584
6222,1,6222,252439785,256059356,0.985864
6250,1,6250,252446035,256059356,0.985889
6254,1,6254,252452289,256059356,0.985913
6257,1,6257,252458546,256059356,0.985938
6330,1,6330,252464876,256059356,0.985962
6481,1,6481,252471357,256059356,0.985988
6489,1,6489,252477846,256059356,0.986013
6593,1,6593,252484439,256059356,0.986039
6621,1,6621,252491060,256059356,0.986065
6691,1,6691,252497751,256059356,0.986091
6733,1,6733,252504484,256059356,0.986117
6802,1,6802,252511286,256059356,0.986144
6803,1,6803,252518089,256059356,0.98617
6877,1,6877,252524966,256059356,0.986197
6972,1,6972,252531938,256059356,0.986224
7057,1,7057,252538995,256059356,0.986252
7185,1,7185,252546180,256059356,0.98628
7186,1,7186,252553366,256059356,0.986308
7293,1,7293,252560659,256059356,0.986336
7309,1,7309,252567968,256059356,0.986365
7344,1,7344,252575312,256059356,0.986394
7368,1,7368,252582680,256059356,0.986422
7384,1,7384,252590064,256059356,0.986451
7515,1,7515,252597579,256059356,0.986481
7529,1,7529,252605108,256059356,0.98651
7587,1,7587,252612695,256059356,0.98654
7623,1,7623,252620318,256059356,0.986569
7762,1,7762,252628080,256059356,0.9866
7793,1,7793,252635873,256059356,0.98663
7946,1,7946,252643819,256059356,0.986661
8000,1,8000,252651819,256059356,0.986692
8012,1,8012,252659831,256059356,0.986724
8123,1,8123,252667954,256059356,0.986755
8127,1,8127,252676081,256059356,0.986787
8136,1,8136,252684217,256059356,0.986819
8187,1,8187,252692404,256059356,0.986851
8369,1,8369,252700773,256059356,0.986884
8412,1,8412,252709185,256059356,0.986916
8424,1,8424,252717609,256059356,0.986949
8458,1,8458,252726067,256059356,0.986982
8519,1,8519,252734586,256059356,0.987016
8555,1,8555,252743141,256059356,0.987049
8575,1,8575,252751716,256059356,0.987083
8740,1,8740,252760456,256059356,0.987117
8842,1,8842,252769298,256059356,0.987151
8843,1,8843,252778141,256059356,0.987186
9150,1,9150,252787291,256059356,0.987221
9224,1,9224,252796515,256059356,0.987257
9366,1,9366,252805881,256059356,0.987294
9418,1,9418,252815299,256059356,0.987331
9509,1,9509,252824808,256059356,0.987368
9556,1,9556,252834364,256059356,0.987405
9611,1,9611,252843975,256059356,0.987443
9817,1,9817,252853792,256059356,0.987481
9876,1,9876,252863668,256059356,0.98752
9877,1,9877,252873545,256059356,0.987558
10000,1,10000,252883545,256059356,0.987597
10001,1,10001,252893546,256059356,0.987636
10035,1,10035,252903581,256059356,0.987676
10127,1,10127,252913708,256059356,0.987715
10533,1,10533,252924241,256059356,0.987756
10756,1,10756,252934997,256059356,0.987798
10988,1,10988,252945985,256059356,0.987841
11051,1,11051,252957036,256059356,0.987884
11111,1,11111,252968147,256059356,0.987928
11360,1,11360,252979507,256059356,0.987972
11420,1,11420,252990927,256059356,0.988017
11524,1,11524,253002451,256059356,0.988062
11613,1,11613,253014064,256059356,0.988107
11887,1,11887,253025951,256059356,0.988154
12321,1,12321,253038272,256059356,0.988202
12763,1,12763,253051035,256059356,0.988251
13033,1,13033,253064068,256059356,0.988302
13282,1,13282,253077350,256059356,0.988354
13369,1,13369,253090719,256059356,0.988406
13629,1,13629,253104348,256059356,0.98846
13706,1,13706,253118054,256059356,0.988513
13935,1,13935,253131989,256059356,0.988568
14337,1,14337,253146326,256059356,0.988624
14708,1,14708,253161034,256059356,0.988681
14897,1,14897,253175931,256059356,0.988739
15213,1,15213,253191144,256059356,0.988799
15339,1,15339,253206483,256059356,0.988859
15406,1,15406,253221889,256059356,0.988919
15701,1,15701,253237590,256059356,0.98898
16151,1,16151,253253741,256059356,0.989043
16280,1,16280,253270021,256059356,0.989107
17035,1,17035,253287056,256059356,0.989173
17128,1,17128,253304184,256059356,0.98924
17244,1,17244,253321428,256059356,0.989307
17391,1,17391,253338819,256059356,0.989375
17933,1,17933,253356752,256059356,0.989445
18188,1,18188,253374940,256059356,0.989516
18453,1,18453,253393393,256059356,0.989588
18507,1,18507,253411900,256059356,0.989661
18641,1,18641,253430541,256059356,0.989734
18786,1,18786,253449327,256059356,0.989807
19014,1,19014,253468341,256059356,0.989881
19369,1,19369,253487710,256059356,0.989957
19944,1,19944,253507654,256059356,0.990035
20018,1,20018,253527672,256059356,0.990113
20764,1,20764,253548436,256059356,0.990194
20856,1,20856,253569292,256059356,0.990275
21586,1,21586,253590878,256059356,0.99036
21933,1,21933,253612811,256059356,0.990445
22191,1,22191,253635002,256059356,0.990532
23750,1,23750,253658752,256059356,0.990625
24544,1,24544,253683296,256059356,0.990721
25115,1,25115,253708411,256059356,0.990819
26435,1,26435,253734846,256059356,0.990922
26910,1,26910,253761756,256059356,0.991027
29354,1,29354,253791110,256059356,0.991142
29759,1,29759,253820869,256059356,0.991258
30871,1,30871,253851740,256059356,0.991378
32604,1,32604,253884344,256059356,0.991506
32715,1,32715,253917059,256059356,0.991634
34444,1,34444,253951503,256059356,0.991768
35922,1,35922,253987425,256059356,0.991908
36127,1,36127,254023552,256059356,0.992049
38672,1,38672,254062224,256059356,0.992201
39867,1,39867,254102091,256059356,0.992356
40488,1,40488,254142579,256059356,0.992514
40945,1,40945,254183524,256059356,0.992674
41047,1,41047,254224571,256059356,0.992835
42193,1,42193,254266764,256059356,0.992999
43359,1,43359,254310123,256059356,0.993169
44954,1,44954,254355077,256059356,0.993344
47649,1,47649,254402726,256059356,0.99353
49878,1,49878,254452604,256059356,0.993725
53150,1,53150,254505754,256059356,0.993933
53680,1,53680,254559434,256059356,0.994142
53830,1,53830,254613264,256059356,0.994353
54839,1,54839,254668103,256059356,0.994567
64700,1,64700,254732803,256059356,0.994819
66083,1,66083,254798886,256059356,0.995077
66649,1,66649,254865535,256059356,0.995338
69242,1,69242,254934777,256059356,0.995608
76475,2,152950,255087727,256059356,0.996205
83781,1,83781,255171508,256059356,0.996533
84174,1,84174,255255682,256059356,0.996861
90471,1,90471,255346153,256059356,0.997215
102674,1,102674,255448827,256059356,0.997616
115618,1,115618,255564445,256059356,0.998067
134603,1,134603,255699048,256059356,0.998593
167542,1,167542,255866590,256059356,0.999247
192766,1,192766,256059356,256059356,1
